productname,2014,2015,2016,2017,Total in Months
Staples,52,39,56,68,215
Easy-staple paper,22,39,31,58,150
Staples in misc. colors,20,6,8,52,86
Staple envelope,54,43,34,39,170
Storex Dura Pro Binders,7,15,12,37,71
Eldon Wave Desk Accessories,14,5,8,34,61
Memorex Mini Travel Drive 16 GB USB 2.0 Flash Drive,7,0,4,34,45
"Lesro Sheffield Collection Coffee Table, End Table, Center Table, Corner Table",2,7,0,30,39
Logitech Desktop MK120 Mouse and keyboard Combo,6,7,8,29,50
Adjustable Depth Letter/Legal Cart,2,12,2,29,45
GBC Instant Report Kit,2,7,12,29,50
Avery Durable Poly Binders,3,0,2,28,33
Strathmore Photo Mount Cards,0,0,10,28,38
"Global Wood Trimmed Manager's Task Chair, Khaki",13,6,13,27,59
O'Sullivan 4-Shelf Bookcase in Odessa Pine,10,0,0,27,37
Satellite Sectional Post Binders,6,0,5,27,38
"Fellowes Mobile File Cart, Black",1,1,11,27,40
Xerox 4200 Series MultiUse Premium Copy Paper (20Lb. and 84 Bright),3,0,1,26,30
Motorola HK250 Universal Bluetooth Headset,0,2,13,26,41
KI Adjustable-Height Table,29,4,16,25,74
Memorex Micro Travel Drive 16 GB,7,4,3,25,39
Avery Metallic Poly Binders,6,0,0,25,31
"Avery Durable Slant Ring Binders, No Labels",5,2,4,25,36
Samsung Galaxy Mega 6.3,5,0,9,25,39
Fellowes Basic Home/Office Series Surge Protectors,2,8,6,25,41
Black & Decker Filter for Double Action Dustbuster Cordless Vac BLDV7210,2,1,0,25,28
Nortel Networks T7316 E Nt8 B27,2,0,2,25,29
"Trav-L-File Heavy-Duty Shuttle II, Black",1,4,0,25,30
"Crayola Anti Dust Chalk, 12/Pack",0,6,4,25,35
Xerox 1968,0,0,1,25,26
Wilson Jones Century Plastic Molded Ring Binders,15,3,6,24,48
"Wirebound Message Book, 4 per Page",9,2,0,24,35
Wilson Jones Easy Flow II Sheet Lifters,6,11,8,24,49
GBC Premium Transparent Covers with Diagonal Lined Pattern,4,21,18,24,67
Staple remover,4,16,17,24,61
Acco 6 Outlet Guardian Premium Plus Surge Suppressor,0,4,3,24,31
"Acco 7-Outlet Masterpiece Power Center, Wihtout Fax/Phone Line Protection",0,2,5,24,31
"Deflect-o RollaMat Studded, Beveled Mat for Medium Pile Carpeting",0,0,2,24,26
Nu-Dell Executive Frame,11,0,5,23,39
Bulldog Vacuum Base Pencil Sharpener,5,0,3,23,31
"Maxell 74 Minute CDR, 10/Pack",3,0,0,23,26
Xerox 191,0,13,3,23,39
Fellowes Stor/Drawer Steel Plus Storage Drawers,11,4,0,22,37
"SimpliFile Personal File, Black Granite, 15w x 6-15/16d x 11-1/4h",7,0,3,22,32
"Wilson Jones Clip & Carry Folder Binder Tool for Ring Binders, Clear",3,0,22,22,47
Newell 325,3,0,9,22,34
Wilson Jones Legal Size Ring Binders,21,2,0,21,44
"Cardinal HOLDit! Binder Insert Strips,Extra Strips",12,0,8,21,41
Staple holder,9,7,15,21,52
Eldon Shelf Savers Cubes and Bins,8,12,4,21,45
"Fellowes Twister Kit, Gray/Clear, 3/pkg",8,7,6,21,42
Storex DuraTech Recycled Plastic Frosted Binders,7,5,6,21,39
Xerox 1919,5,11,3,21,40
"Situations Contoured Folding Chairs, 4/Set",4,13,26,21,64
Newell 312,2,19,7,21,49
Newell 311,0,4,5,21,30
Fellowes 8 Outlet Superior Workstation Surge Protector w/o Phone/Fax/Modem Protection,0,4,0,21,25
Avery Non-Stick Binders,14,14,23,20,71
Advantus Plastic Paper Clips,12,5,10,20,47
Acco 3-Hole Punch,11,3,2,20,36
SAFCO Boltless Steel Shelving,6,7,13,20,46
Vinyl Sectional Post Binders,6,5,9,20,40
Peel-Off China Markers,5,6,0,20,31
GBC VeloBinder Manual Binding System,4,4,2,20,30
Cardinal EasyOpen D-Ring Binders,3,8,9,20,40
Premium Transparent Presentation Covers by GBC,3,0,20,20,43
"Peel & Seel Recycled Catalog Envelopes, Brown",3,0,3,20,26
Flat Face Poster Frame,0,14,17,20,51
Global Ergonomic Managers Chair,0,7,12,20,39
"Bush Westfield Collection Bookcases, Medium Cherry Finish",0,6,6,20,32
Chromcraft Round Conference Tables,0,2,39,20,61
"Premier Elliptical Ring Binder, Black",16,2,9,19,46
DMI Arturo Collection Mission-style Design Wood Chair,16,0,2,19,37
Staple-based wall hangings,13,13,17,19,62
GBC DocuBind TL300 Electric Binding System,11,5,2,19,37
Fellowes Officeware Wire Shelving,9,22,5,19,55
Fluorescent Highlighters by Dixon,7,0,0,19,26
Newell 347,5,8,0,19,32
Iris Project Case,4,7,0,19,30
Letter Size Cart,4,5,5,19,33
"Bush Andora Bookcase, Maple/Graphite Gray Finish",3,5,7,19,34
3M Organizer Strips,3,4,0,19,26
"SlimView Poly Binder, 3/8""",2,19,0,19,40
GBC DocuBind TL200 Manual Binding Machine,1,3,0,19,23
Polycom SoundPoint IP 450 VoIP phone,1,0,2,19,22
Xerox 1996,0,4,5,19,28
"Neat Ideas Personal Hanging Folder Files, Black",0,3,0,19,22
Xerox 1905,0,0,4,19,23
Xerox 230,0,0,2,19,21
Maxell 4.7GB DVD-R,16,8,7,18,49
Xerox 1893,13,0,8,18,39
Avery Durable Binders,12,17,3,18,50
Avery File Folder Labels,9,6,11,18,44
"ACCOHIDE 3-Ring Binder, Blue, 1""",9,5,12,18,44
Ibico Hi-Tech Manual Binding System,9,2,5,18,34
Avery 505,5,5,0,18,28
Hewlett Packard LaserJet 3310 Copier,5,2,13,18,38
WD My Passport Ultra 2TB Portable External Hard Drive,5,0,12,18,35
GBC DocuBind P50 Personal Binding Machine,4,14,14,18,50
"Acco Data Flex Cable Posts For Top & Bottom Load Binders, 6 Capacity""",2,11,8,18,39
SanDisk Cruzer 64 GB USB Flash Drive,2,3,11,18,34
Global Commerce Series Low-Back Swivel/Tilt Chairs,2,1,3,18,24
Kingston Digital DataTraveler 16GB USB 2.0,1,20,18,18,57
Microsoft Sculpt Comfort Mouse,0,11,13,18,42
Belkin 5 Outlet SurgeMaster Power Centers,0,8,14,18,40
Fellowes Bankers Box Staxonsteel Drawer File/Stacking System,0,7,18,18,43
"TRENDnet 56K USB 2.0 Phone, Internet and Fax Modem",0,7,0,18,25
Xerox 1908,0,5,9,18,32
Sterilite Officeware Hinged File Box,0,3,14,18,35
Zipper Ring Binder Pockets,15,4,8,17,44
Xerox 1909,15,0,8,17,40
4009 Highlighters by Sanford,13,5,9,17,44
DXL Angle-View Binders with Locking Rings by Samsill,10,0,8,17,35
"Avery Address/Shipping Labels for Typewriters, 4 x 2""""",9,0,2,17,28
Geemarc AmpliPOWER60,7,12,10,17,46
Samsung Galaxy S III - 16GB - pebble blue (T-Mobile),7,2,2,17,28
Tennsco Double-Tier Lockers,6,7,17,17,47
GE 30524EE4,6,2,7,17,32
Xerox 1906,4,8,3,17,32
Fellowes Binding Cases,4,6,4,17,31
Xerox 1891,3,8,2,17,30
Sony 64GB Class 10 Micro SDHC R40 Memory Card,3,3,4,17,27
Eldon Gobal File Keepers,2,3,2,17,24
Kensington 7 Outlet MasterPiece HOMEOFFICE Power Control Center,2,0,2,17,21
Aluminum Screw Posts,0,21,3,17,41
Self-Adhesive Removable Labels,0,15,3,17,35
Logitech G19 Programmable Gaming Keyboard,0,13,6,17,36
Xerox 1997,0,11,2,17,30
GBC Twin Loop Wire Binding Elements,0,8,22,17,47
OtterBox Defender Series Case - Samsung Galaxy S4,0,5,5,17,27
Xerox 1930,0,5,2,17,24
Google Nexus 5,0,3,3,17,23
Economy Binders,0,2,0,17,19
Avery 511,0,1,2,17,20
"C-Line Magnetic Cubicle Keepers, Clear Polypropylene",0,0,11,17,28
PayAnywhere Card Reader,0,0,8,17,25
Avanti 1.7 Cu. Ft. Refrigerator,0,0,7,17,24
Xerox 1939,0,0,5,17,22
"Rediform S.O.S. 1-Up Phone Message Bk, 4-1/4x3-1/16 Bk, 1 Form/Pg, 40 Messages/Bk, 3/Pk",0,0,4,17,21
GBC VeloBind Cover Sets,10,0,16,16,42
Avery 518,9,3,7,16,35
Xerox 220,9,0,0,16,25
Ibico Plastic and Wire Spiral Binding Combs,8,4,13,16,41
Xerox 1888,8,0,0,16,24
Honeywell Enviracaire Portable HEPA Air Cleaner for 17' x 22' Room,7,4,13,16,40
Fellowes PB300 Plastic Comb Binding Machine,7,4,0,16,27
Canvas Sectional Post Binders,6,0,6,16,28
Martin Yale Chadless Opener Electric Letter Opener,5,1,0,16,22
Logitech Wireless Headset h800,4,6,6,16,32
Newell 310,3,5,1,16,25
Xerox 203,3,5,0,16,24
Bevis 36 x 72 Conference Tables,1,18,5,16,40
Iceberg Mobile Mega Data/Printer Cart ,0,12,21,16,49
Hon 4070 Series Pagoda Armless Upholstered Stacking Chairs,0,12,6,16,34
Memorex Froggy Flash Drive 8 GB,0,9,7,16,32
"GBC Velobind Prepunched Cover Sets, Regency Series",0,8,9,16,33
Ibico Presentation Index for Binding Systems,0,2,9,16,27
"Eureka Sanitaire  Multi-Pro Heavy-Duty Upright, Disposable Bags",0,2,4,16,22
Anker Ultrathin Bluetooth Wireless Keyboard Aluminum Cover with Stand ,0,1,0,16,17
BIC Liqua Brite Liner,0,0,11,16,27
Newell 318,0,0,7,16,23
Avery 478,0,0,2,16,18
Pencil and Crayon Sharpener,0,0,0,16,16
Fellowes Bankers Box Stor/Drawer Steel Plus,20,5,10,15,50
Lock-Up Easel 'Spel-Binder',13,9,7,15,44
Wilson Jones Leather-Like Binders with DublLock Round Rings,12,8,11,15,46
Toshiba IPT2010-SD IP Telephone,9,7,0,15,31
Pressboard Hanging Data Binders for Unburst Sheets,8,8,17,15,48
12-1/2 Diameter Round Wall Clock,8,6,7,15,36
"Adams Telephone Message Book w/Frequently-Called Numbers Space, 400 Messages per Book",8,5,0,15,28
Global Super Steno Chair,7,6,2,15,30
Binder Clips by OIC,6,6,0,15,27
X-Rack File for Hanging Folders,5,2,8,15,30
Griffin GC17055 Auxiliary Audio Cable,4,0,8,15,27
Tennsco Commercial Shelving,4,0,2,15,21
Xerox 209,3,3,8,15,29
Grandstream GXP1160 VoIP phone,3,3,3,15,24
Imation 8gb Micro Traveldrive Usb 2.0 Flash Drive,3,2,5,15,25
"#10- 4 1/8 x 9 1/2"" Security-Tint Envelopes""",3,0,3,15,21
Nu-Dell Leatherette Frames,3,0,0,15,18
Avery Recycled Flexi-View Covers for Binding Systems,2,12,3,15,32
Logitech Wireless Marathon Mouse M705,2,6,7,15,30
Stackable Trays,2,6,0,15,23
Belkin Premiere Surge Master II 8-outlet surge protector,2,4,5,15,26
Tensor Track Tree Floor Lamp,2,0,0,15,17
"Avery 4027 File Folder Labels for Dot Matrix Printers, 5000 Labels per Box, White",1,21,6,15,43
Binding Machine Supplies,0,3,14,15,32
"Wirebound Message Books, Four 2 3/4 x 5 Forms per Page, 200 Sets per Book",0,2,9,15,26
Stanley Bostitch Contemporary Electric Pencil Sharpeners,0,2,2,15,19
Microsoft Wireless Mobile Mouse 4000,0,0,0,15,15
Boston 1799 Powerhouse Electric Pencil Sharpener,0,0,0,15,15
Pyle PMP37LED,17,5,7,14,43
"Hunt PowerHouse Electric Pencil Sharpener, Blue",12,16,2,14,44
"Wilson Jones 1 Hanging DublLock Ring Binders""",10,10,12,14,46
GBC Prestige Therm-A-Bind Covers,10,10,5,14,39
"Global Stack Chair without Arms, Black",9,6,15,14,44
Ibico Plastic Spiral Binding Combs,8,13,12,14,47
HON 5400 Series Task Chairs for Big and Tall,8,10,7,14,39
Xerox 1917,7,4,0,14,25
Xerox 1947,7,0,4,14,25
Avery Hole Reinforcements,6,12,0,14,32
"Global Fabric Manager's Chair, Dark Gray",6,8,7,14,35
"Master Big Foot Doorstop, Beige",6,6,4,14,30
OIC Stacking Trays,6,3,7,14,30
Recycled Easel Ring Binders,6,2,13,14,35
Space Solutions Commercial Steel Shelving,5,14,0,14,33
"Tenex Traditional Chairmats for Medium Pile Carpet, Standard Lip, 36 x 48""""",5,5,0,14,24
Plantronics Voyager Pro HD - Bluetooth Headset,5,0,6,14,25
"Acco Flexible ACCOHIDE Square Ring Data Binder, Dark Blue, 11 1/2 X 14"" 7/8""""",4,14,4,14,36
Motorola L804,4,0,1,14,19
Xerox 1945,3,11,17,14,45
Logitech P710e Mobile Speakerphone,3,3,21,14,41
Xerox 1927,3,1,0,14,18
Logitech Illuminated - Keyboard,3,0,3,14,20
3.6 Cubic Foot Counter Height Office Refrigerator,3,0,1,14,18
Fellowes PB500 Electric Punch Plastic Comb Binding Machine with Manual Bind,2,13,2,14,31
Astroparche Fine Business Paper,2,5,8,14,29
Prismacolor Color Pencil Set,2,4,4,14,24
Logitech ClearChat Comfort/USB Headset H390,2,0,3,14,19
"Sortfiler Multipurpose Personal File Organizer, Black",1,3,6,14,24
"Eldon 200 Class Desk Accessories, Smoke",1,0,7,14,22
Kensington Orbit Wireless Mobile Trackball for PC and Mac,0,10,9,14,33
Razer Tiamat Over Ear 7.1 Surround Sound PC Gaming Headset,0,9,3,14,26
Memorex Mini Travel Drive 8 GB USB 2.0 Flash Drive,0,6,0,14,20
"DAX Two-Tone Rosewood/Black Document Frame, Desktop, 5 x 7",0,4,7,14,25
Panasonic KX-TG6844B Expandable Digital Cordless Telephone,0,4,4,14,22
"Ampad Phone Message Book, Recycled, 400 Message Capacity, 5 ¾” x 11”",0,4,2,14,20
Plantronics Audio 995 Wireless Stereo Headset,0,3,1,14,18
"Howard Miller 11-1/2 Diameter Brentwood Wall Clock""",0,3,0,14,17
Avery Printable Repositionable Plastic Tabs,0,1,1,14,16
Avery 473,0,0,10,14,24
"Eldon 400 Class Desk Accessories, Black Carbon",0,0,8,14,22
Blue Parrot B250XT Professional Grade Wireless Bluetooth Headset with,0,0,7,14,21
Hoover Commercial SteamVac,0,0,0,14,14
iOttie XL Car Mount,0,0,0,14,14
Fellowes Superior 10 Outlet Split Surge Protector,13,4,0,13,30
"File Shuttle II and Handi-File, Black",10,0,11,13,34
Maxell LTO Ultrium - 800 GB,9,19,0,13,41
GBC Recycled Regency Composition Covers,9,4,0,13,26
Sensible Storage WireTech Storage Systems,9,0,16,13,38
Vtech CS6719,8,11,0,13,32
"Eldon 200 Class Desk Accessories, Burgundy",7,5,0,13,25
"Chromcraft 48 x 96"" Racetrack Double Pedestal Table""",7,0,2,13,22
Hunt Boston Vacuum Mount KS Pencil Sharpener,7,0,0,13,20
Xerox 1887,6,9,2,13,30
Hon 5100 Series Wood Tables,6,0,7,13,26
Wilson Jones Impact Binders,5,16,8,13,42
Wilson Electronics DB Pro Signal Booster,5,10,4,13,32
Fellowes Bases and Tops For Staxonsteel/High-Stak Systems,4,6,3,13,26
Newell 314,4,5,2,13,24
invisibleSHIELD by ZAGG Smudge-Free Screen Protector,3,3,10,13,29
AT&T 841000 Phone,3,2,10,13,28
Green Bar Computer Printout Paper,3,0,1,13,17
Global Deluxe Steno Chair,2,6,8,13,29
"Eberhard Faber 3 1/2 Golf Pencils""",2,0,5,13,20
BoxOffice By Design Rectangular and Half-Moon Meeting Room Tables,2,0,0,13,15
Logitech Wireless Touch Keyboard K400,2,0,0,13,15
"Riverside Furniture Oval Coffee Table, Oval End Table, End Table with Drawer",1,11,0,13,25
Xerox 1894,0,12,2,13,27
Tripp Lite Isotel 6 Outlet Surge Protector with Fax/Modem Protection,0,9,5,13,27
"Acme 10 Easy Grip Assistive Scissors""",0,9,4,13,26
Motorola L703CM,0,7,12,13,32
"Adams Phone Message Book, 200 Message Capacity, 8 1/16” x 11”",0,6,14,13,33
"Belkin SportFit Armband For iPhone 5s/5c, Fuchsia",0,3,5,13,21
Imation Bio 2GB USB Flash Drive Imation Corp,0,3,0,13,16
Howard Miller Distant Time Traveler Alarm Clock,0,2,6,13,21
"Bush Westfield Collection Bookcases, Fully Assembled",0,0,5,13,18
Berol Giant Pencil Sharpener,0,0,4,13,17
Logitech G13 Programmable Gameboard with LCD Display,0,0,1,13,14
Bulldog Table or Wall-Mount Pencil Sharpener,0,0,0,13,13
"GBC Standard Recycled Report Covers, Clear Plastic Sheets",19,5,15,12,51
9-3/4 Diameter Round Wall Clock,13,1,8,12,34
"Bevis Oval Conference Table, Walnut",12,8,4,12,36
"Dual Level, Single-Width Filing Carts",11,10,10,12,43
SanDisk Ultra 32 GB MicroSDHC Class 10 Memory Card,11,8,13,12,44
Bestar Classic Bookcase,11,3,5,12,31
Xerox 1931,10,6,8,12,36
Hon GuestStacker Chair,9,3,10,12,34
"Lifetime Advantage Folding Chairs, 4/Carton",9,2,4,12,27
GBC DocuBind 300 Electric Binding Machine,8,1,2,12,23
Office Impressions Heavy Duty Welded Shelving & Multimedia Storage Drawers,8,0,0,12,20
Newell 350,8,0,0,12,20
"Performers Binder/Pad Holder, Black",7,9,8,12,36
Tennsco Single-Tier Lockers,7,6,3,12,28
"Premium Transparent Presentation Covers, No Pattern/Clear, 8 1/2 x 11""""",7,0,10,12,29
3M Hangers With Command Adhesive,6,7,8,12,33
Cardinal Holdit Business Card Pockets,6,3,4,12,25
Wilson Jones Turn Tabs Binder Tool for Ring Binders,5,12,30,12,59
Insertable Tab Post Binder Dividers,5,5,3,12,25
"Binney & Smith inkTank Desk Highlighter, Chisel Tip, Yellow, 12/Box",5,5,0,12,22
Wilson Jones Four-Pocket Poly Binders,5,0,0,12,17
O'Sullivan 2-Shelf Heavy-Duty Bookcases,4,4,1,12,21
Bush Advantage Collection Racetrack Conference Table,3,12,6,12,33
"Eldon Image Series Desk Accessories, Burgundy",3,10,6,12,31
Imation Secure Drive + Hardware Encrypted USB flash drive - 16 GB,3,7,2,12,24
"Memorex 25GB 6X Branded Blu-Ray Recordable Disc, 15/Pack",3,6,5,12,26
Acco Suede Grain Vinyl Round Ring Binder,3,5,9,12,29
SANFORD Major Accent Highlighters,3,3,12,12,30
"Eaton Premium Continuous-Feed Paper, 25% Cotton, Letter Size, White, 1000 Shts/Box",3,3,3,12,21
Boston 16801 Nautilus Battery Pencil Sharpener,3,0,8,12,23
Avery 475,3,0,3,12,18
Xerox 1992,3,0,0,12,15
Avery 48,3,0,0,12,15
GBC Recycled VeloBinder Covers,2,15,13,12,42
Tenex B1-RE Series Chair Mats for Low Pile Carpets,2,8,1,12,23
Rogers Handheld Barrel Pencil Sharpener,2,4,12,12,30
Hon 61000 Series Interactive Training Tables,2,1,7,12,22
Permanent Self-Adhesive File Folder Labels for Typewriters by Universal,2,1,3,12,18
Accohide Poly Flexible Ring Binders,1,15,6,12,34
Plantronics CS510 - Over-the-Head monaural Wireless Headset System,1,9,13,12,35
Avery 474,0,16,2,12,30
Global Chrome Stack Chair,0,14,6,12,32
Deluxe Heavy-Duty Vinyl Round Ring Binder,0,10,11,12,33
Xerox 1915,0,6,10,12,28
Hoover Portapower Portable Vacuum,0,6,0,12,18
Carina Media Storage Towers in Natural & Black,0,5,3,12,20
Steel Personal Filing/Posting Tote,0,4,13,12,29
GBC Plasticlear Binding Covers,0,4,7,12,23
Anker 36W 4-Port USB Wall Charger Travel Power Adapter for iPhone 5s 5c 5,0,3,7,12,22
Polycom CX600 IP Phone VoIP phone,0,2,3,12,17
Eldon Antistatic Chair Mats for Low to Medium Pile Carpets,0,2,0,12,14
Ricoh - Ink Collector Unit for GX3000 Series Printers,0,2,0,12,14
Xerox 231,0,1,1,12,14
Logitech MX Performance Wireless Mouse,0,0,11,12,23
"Office Impressions End Table, 20-1/2H x 24""W x 20""D""",0,0,11,12,23
GBC ProClick 150 Presentation Binding System,0,0,10,12,22
Sanyo 2.5 Cubic Foot Mid-Size Office Refrigerators,0,0,5,12,17
Avery 517,0,0,1,12,13
iHome FM Clock Radio with Lightning Dock,0,0,1,12,13
Logitech 910-002974 M325 Wireless Mouse for Web Scrolling,20,14,7,11,52
Bretford Rectangular Conference Table Tops,19,4,12,11,46
I Need's 3d Hello Kitty Hybrid Silicone Case Cover for HTC One X 4g with 3d Hello Kitty Stylus Pen Green/pink,17,15,9,11,52
"Cardinal Slant-D Ring Binder, Heavy Gauge Vinyl",17,0,9,11,37
Tensor Computer Mounted Lamp,15,10,0,11,36
"Decoflex Hanging Personal Folder File, Blue",15,9,0,11,35
Hon Multipurpose Stacking Arm Chairs,14,7,4,11,36
GBC Durable Plastic Covers,14,2,7,11,34
"Maxell Pro 80 Minute CD-R, 10/Pack",13,0,0,11,24
Carina Double Wide Media Storage Towers in Natural & Black,12,12,4,11,39
Xerox 1884,11,9,1,11,32
Prang Colored Pencils,11,5,5,11,32
Imation Secure+ Hardware Encrypted USB 2.0 Flash Drive  16GB,9,0,12,11,32
"#10- 4 1/8 x 9 1/2"" Recycled Envelopes""",9,17,0,11,37
Xerox 225,8,3,11,11,33
"BIC Brite Liner Highlighters, Chisel Tip",8,2,0,11,21
"Global High-Back Leather Tilter, Burgundy",7,20,16,11,54
"Dot Matrix Printer Tape Reel Labels, White, 5000/Box",7,10,8,11,36
Prang Dustless Chalk Sticks,7,4,2,11,24
"Bevis Round Conference Table Top, X-Base",7,2,0,11,20
Adjustable Personal File Tote,7,0,0,11,18
"Holmes Replacement Filter for HEPA Air Cleaner, Medium Room",7,0,0,11,18
"Acco Six-Outlet Power Strip, 4' Cord Length",6,12,12,11,41
"Gould Plastics 18-Pocket Panel Bin, 34w x 5-1/4d x 20-1/2h",6,6,5,11,28
Eldon Fold 'N Roll Cart System,6,2,5,11,24
Hon 4-Shelf Metal Bookcases,6,0,5,11,22
"Vinyl Coated Wire Paper Clips in Organizer Box, 800/Box",5,13,0,11,29
"Office Star - Contemporary Task Swivel chair with Loop Arms, Charcoal",5,9,10,11,35
"Global Airflow Leather Mesh Back Chair, Black",5,2,14,11,32
Plymouth Boxed Rubber Bands by Plymouth,5,2,0,11,18
"Global Leather and Oak Executive Chair, Black",4,4,7,11,26
Kensington Expert Mouse Optical USB Trackball for PC or Mac,4,0,5,11,20
BIC Brite Liner Grip Highlighters,4,0,2,11,17
"SAFCO Mobile Desk Side File, Wire Frame",3,13,4,11,31
Harbour Creations 67200 Series Stacking Chairs,3,6,4,11,24
Prestige Round Ring Binders,3,5,2,11,21
Acco Translucent Poly Ring Binders,3,3,14,11,31
"Eldon Executive Woodline II Desk Accessories, Mahogany",3,3,0,11,17
BIC Brite Liner Highlighters,3,2,7,11,23
Colored Envelopes,3,2,0,11,16
Imation 16GB Mini TravelDrive USB 2.0 Flash Drive,3,0,20,11,34
"Verbatim 25 GB 6x Blu-ray Single Layer Recordable Disc, 10/Pack",3,0,0,11,14
"GBC Prepunched Paper, 19-Hole, for Binding Systems, 24-lb",2,15,10,11,38
GBC Standard Plastic Binding Systems' Combs,2,12,5,11,30
Avanti 4.4 Cu. Ft. Refrigerator,2,11,0,11,24
Global Troy Executive Leather Low-Back Tilter,2,5,14,11,32
Polycom VoiceStation 500 Conference phone,2,2,0,11,15
QVS USB Car Charger 2-Port 2.1Amp for iPod/iPhone/iPad/iPad 2/iPad 3,2,0,0,11,13
Aastra 57i VoIP phone,1,8,6,11,26
Spigen Samsung Galaxy S5 Case Wallet,1,3,0,11,15
Avery Reinforcements for Hole-Punch Pages,0,19,11,11,41
Tuf-Vin Binders,0,15,0,11,26
"Tenex Personal Project File with Scoop Front Design, Black",0,13,16,11,40
"It's Hot Message Books with Stickers, 2 3/4 x 5""""",0,10,4,11,25
Newell 336,0,7,0,11,18
"Advantus 10-Drawer Portable Organizer, Chrome Metal Frame, Smoke Drawers",0,7,0,11,18
"Hon Metal Bookcases, Putty",0,6,2,11,19
Things To Do Today Pad,0,5,10,11,26
"Eldon Expressions Punched Metal & Wood Desk Accessories, Black & Cherry",0,5,4,11,20
"Tenex The Solids"" Textured Chair Mats""",0,4,11,11,26
Kensington K72356US Mouse-in-a-Box USB Desktop Mouse,0,4,5,11,20
Cardinal Slant-D Ring Binders,0,4,2,11,17
Motorla HX550 Universal Bluetooth Headset,0,4,0,11,15
Fellowes Powershred HS-440 4-Sheet High Security Shredder,0,3,3,11,17
Logitech Media Keyboard K200,0,3,2,11,16
Luxo Professional Fluorescent Magnifier Lamp with Clamp-Mount Base,0,2,10,11,23
"Global Leather Task Chair, Black",0,1,7,11,19
Premier Electric Letter Opener,0,0,13,11,24
Canon imageCLASS 2200 Advanced Copier,0,0,9,11,20
Belkin F9S820V06 8 Outlet Surge,0,0,6,11,17
Panasonic KX - TS880B Telephone,0,0,0,11,11
Nokia Lumia 925,0,0,0,11,11
"OIC Colored Binder Clips, Assorted Sizes",19,0,15,10,44
Crayola Colored Pencils,18,9,3,10,40
Dixon Ticonderoga Core-Lock Colored Pencils,16,2,0,10,28
Global Commerce Series High-Back Swivel/Tilt Chairs,15,3,5,10,33
Alphabetical Labels for Top Tab Filing,15,0,12,10,37
"Angle-D Binders with Locking Rings, Label Holders",13,7,12,10,42
DAX Wood Document Frame,11,19,0,10,40
Prang Drawing Pencil Set,11,7,11,10,39
Xerox 1988,9,18,4,10,41
Newell 35,9,5,6,10,30
Panasonic KX-TG9541B DECT 6.0 Digital 2-Line Expandable Cordless Phone With Digital Answering System,9,3,3,10,25
Xerox 2,8,4,3,10,25
Jawbone MINI JAMBOX Wireless Bluetooth Speaker,8,0,0,10,18
Novimex Fabric Task Chair,7,10,12,10,39
Safco Industrial Wire Shelving System,7,8,5,10,30
Fellowes Black Plastic Comb Bindings,7,6,11,10,34
Standard Rollaway File with Lock,7,5,18,10,40
Eldon Portable Mobile Manager,7,5,12,10,34
Avery 481,7,0,13,10,30
"Avery Flip-Chart Easel Binder, Black",7,0,0,10,17
Logitech G430 Surround Sound Gaming Headset with Dolby 7.1 Technology,7,0,0,10,17
"DataProducts Ampli Magnifier Task Lamp, Black,",6,5,0,10,21
Office Star - Mesh Screen back chair with Vinyl seat,6,4,0,10,20
GBC Recycled Grain Textured Covers,6,4,0,10,20
Clear Mylar Reinforcing Strips,6,2,11,10,29
Kingston Digital DataTraveler 32GB USB 2.0,6,0,6,10,22
Logitech Wireless Gaming Headset G930,6,0,5,10,21
Letter or Legal Size Expandable Poly String Tie Envelopes,6,0,0,10,16
"GBC White Gloss Covers, Plain Front",5,8,8,10,31
Hon 2111 Invitation Series Straight Table,5,3,0,10,18
Avery 512,5,0,17,10,32
ACCOHIDE Binder by Acco,5,0,6,10,21
Avery Fluorescent Highlighter Four-Color Set,4,8,2,10,24
Recycled Steel Personal File for Hanging File Folders,4,5,2,10,21
Kensington 6 Outlet Guardian Standard Surge Protector,4,3,3,10,20
Xerox 23,4,1,8,10,23
Avery 519,4,0,4,10,18
Memorex Micro Travel Drive 8 GB,3,7,6,10,26
"Super Bands, 12/Pack",3,7,0,10,20
Xerox 1885,3,3,4,10,20
Spiral Phone Message Books with Labels by Adams,3,2,0,10,15
"Sanford Uni-Blazer View Highlighters, Chisel Tip, Yellow",3,1,0,10,14
Panasonic KX TS208W Corded phone,3,0,19,10,32
"24 Capacity Maxi Data Binder Racks, Pearl",3,0,6,10,19
"O'Sullivan Elevations Bookcase, Cherry Finish",3,0,5,10,18
Things To Do Today Spiral Book,3,0,0,10,13
Catalog Binders with Expanding Posts,2,18,6,10,36
"Eldon Expressions Wood Desk Accessories, Oak",2,14,7,10,33
Logitech G700s Rechargeable Gaming Mouse,2,11,2,10,25
DAX Wood Document Frame.,2,4,0,10,16
Eureka The Boss Cordless Rechargeable Stick Vac,2,3,4,10,19
Acme Forged Steel Scissors with Black Enamel Handles,2,0,20,10,32
Dax Clear Box Frame,2,0,2,10,14
Xerox 1940,2,0,0,10,12
Chromcraft Bull-Nose Wood Oval Conference Tables & Bases,1,13,3,10,27
Xerox 1924,1,0,1,10,12
PureGear Roll-On Screen Protector,0,19,5,10,34
Manco Dry-Lighter Erasable Highlighter,0,19,1,10,30
GBC Imprintable Covers,0,18,8,10,36
"Howard Miller 13-3/4 Diameter Brushed Chrome Round Wall Clock""",0,10,11,10,31
Acme Tagit Stainless Steel Antibacterial Scissors,0,7,5,10,22
Newell 309,0,7,3,10,20
Aastra 6757i CT Wireless VoIP phone,0,6,0,10,16
OtterBox Commuter Series Case - iPhone 5 & 5s,0,6,0,10,16
Newell 344,0,5,3,10,18
"Quartet Omega Colored Chalk, 12/Pack",0,5,0,10,15
Xerox 227,0,4,8,10,22
Acme Galleria Hot Forged Steel Scissors with Colored Handles,0,3,0,10,13
Eldon 200 Class Desk Accessories,0,2,10,10,22
Microsoft Natural Ergonomic Keyboard 4000,0,2,7,10,19
Logitech LS21 Speaker System - PC Multimedia - 2.1-CH - Wired,0,1,0,10,11
Samsung Replacement EH64AVFWE Premium Headset,0,0,11,10,21
Avery Durable Slant Ring Binders,0,0,9,10,19
Acme Preferred Stainless Steel Scissors,0,0,6,10,16
"Telephone Message Books with Fax/Mobile Section, 4 1/4 x 6""""",0,0,5,10,15
Imation 8GB Mini TravelDrive USB 2.0 Flash Drive,0,0,3,10,13
Xerox 1982,0,0,2,10,12
Hewlett-Packard 300S Scientific Calculator,0,0,0,10,10
Maxell iVDR EX 500GB Cartridge,0,0,0,10,10
SAFCO Arco Folding Chair,23,10,11,9,53
"Avery Hi-Liter EverBold Pen Style Fluorescent Highlighters, 4/Pack",22,0,0,9,31
Ibico Ibimaster 300 Manual Binding System,15,0,4,9,28
Xerox 1895,12,6,6,9,33
Hon 94000 Series Round Tables,12,3,6,9,30
Weyerhaeuser First Choice Laser/Copy Paper (20Lb. and 88 Bright),12,1,3,9,25
Xerox 214,11,5,12,9,37
KI Conference Tables,10,19,6,9,44
"Global Value Mid-Back Manager's Chair, Gray",10,12,8,9,39
GuestStacker Chair with Chrome Finish Legs,10,12,0,9,31
Acco D-Ring Binder w/DublLock,10,12,0,9,31
Logitech Wireless Performance Mouse MX for PC and Mac,10,2,0,9,21
"Global Geo Office Task Chair, Gray",10,1,5,9,25
Cisco SPA525G2 IP Phone - Wireless,9,2,6,9,26
Plantronics Audio 478 Stereo USB Headset,8,8,9,9,34
"SAFCO PlanMaster Boards, 60w x 37-1/2d, White Melamine",8,3,6,9,26
Sanford Liquid Accent Highlighters,8,2,5,9,24
OIC Binder Clips,7,11,11,9,38
Eldon Simplefile Box Office,7,4,10,9,30
SanDisk Cruzer 32 GB USB Flash Drive,6,0,5,9,20
Fashion Color Clasp Envelopes,6,0,0,9,15
"Redi-Strip #10 Envelopes, 4 1/8 x 9 1/2",5,12,9,9,35
Bretford CR4500 Series Slim Rectangular Table,5,11,4,9,29
"OIC #2 Pencils, Medium Soft",5,2,1,9,17
"LF Elite 3D Dazzle Designer Hard Case Cover, Lf Stylus Pen and Wiper For Apple Iphone 5c Mini Lite",5,0,14,9,28
"Recycled Data-Pak for Archival Bound Computer Printouts, 12-1/2 x 12-1/2 x 16",5,0,6,9,20
Eldon Radial Chair Mat for Low to Medium Pile Carpets,5,0,6,9,20
"Letter/Legal File Tote with Clear Snap-On Lid, Black Granite",5,0,0,9,14
Office Star - Mid Back Dual function Ergonomic High Back Chair with 2-Way Adjustable Arms,4,10,8,9,31
Xerox 197,4,5,0,9,18
SpineVue Locking Slant-D Ring Binders by Cardinal,4,3,6,9,22
Balt Solid Wood Round Tables,4,0,6,9,19
Xerox 221,4,0,1,9,14
Office Star - Contemporary Swivel Chair with Padded Adjustable Arms and Flex Back,3,13,7,9,32
Global Low Back Tilter Chair,3,3,6,9,21
Digium D40 VoIP phone,2,12,4,9,27
Nortel Meridian M3904 Professional Digital phone,2,11,10,9,32
Xerox 1916,2,8,1,9,20
"Acco PRESSTEX Data Binder with Storage Hooks, Light Blue, 9 1/2 X 11""""",2,2,4,9,17
Luxo Professional Combination Clamp-On Lamps,2,2,0,9,13
"Advantus Push Pins, Aluminum Head",2,1,12,9,24
Rogers Deluxe File Chest,2,1,10,9,22
Bionaire Personal Warm Mist Humidifier/Vaporizer,2,0,0,9,11
Avoid Verbal Orders Carbonless Minifold Book,1,11,0,9,21
"Bravo II Megaboss 12-Amp Hard Body Upright, Replacement Belts, 2 Belts per Pack",1,7,12,9,29
Xerox 189,1,0,9,9,19
Plantronics Encore H101 Dual Earpieces Headset,1,0,8,9,18
Logitech diNovo Edge Keyboard,0,13,9,9,31
"Advantus Employee of the Month Certificate Frame, 11 x 13-1/2",0,13,6,9,28
"Tennsco Lockers, Sand",0,13,0,9,22
O'Sullivan 3-Shelf Heavy-Duty Bookcases,0,13,0,9,22
O'Sullivan 2-Door Barrister Bookcase in Odessa Pine,0,9,13,9,31
"Atlantic Metals Mobile 5-Shelf Bookcases, Custom Colors",0,9,8,9,26
Mobile Personal File Cube,0,8,4,9,21
Imation Bio 8GB USB Flash Drive Imation Corp,0,7,0,9,16
Novimex Turbo Task Chair,0,5,8,9,22
Tripp Lite Isotel 8 Ultra 8 Outlet Metal Surge,0,5,2,9,16
Newell 349,0,5,0,9,14
Newell 323,0,5,0,9,14
Hanging Personal Folder File,0,4,4,9,17
"Ativa D5772 2-Line 5.8GHz Digital Expandable Corded/Cordless Phone System with Answering & Caller ID/Call Waiting, Black/Silver",0,3,0,9,12
Personal File Boxes with Fold-Down Carry Handle,0,3,0,9,12
Tops White Computer Printout Paper,0,2,3,9,14
"Eureka The Boss Lite 10-Amp Upright Vacuum, Blue",0,2,2,9,13
Design Ebony Sketching Pencil,0,2,0,9,11
"Bush Cubix Conference Tables, Fully Assembled",0,0,10,9,19
"Seth Thomas 12 Clock w/ Goldtone Case""",0,0,8,9,17
Avery 498,0,0,4,9,13
Xerox 1998,0,0,0,9,9
"Post-it “Important Message” Note Pad, Neon Colors, 50 Sheets/Pad",0,0,0,9,9
Panasonic KP-310 Heavy-Duty Electric Pencil Sharpener,0,0,0,9,9
"Bush Birmingham Collection Bookcase, Dark Cherry",0,0,0,9,9
Avery 499,18,6,8,8,40
GBC ProClick Punch Binding System,16,0,7,8,31
Polycom VVX 310 VoIP phone,13,11,8,8,40
"Hon Deluxe Fabric Upholstered Stacking Chairs, Rounded Back",13,0,30,8,51
Longer-Life Soft White Bulbs,12,10,14,8,44
SanDisk Ultra 16 GB MicroSDHC Class 10 Memory Card,12,10,1,8,31
Avery Arch Ring Binders,12,7,13,8,40
Stockwell Push Pins,12,7,7,8,34
"Padded Folding Chairs, Black, 4/Carton",12,7,3,8,30
"Howard Miller 13 Diameter Goldtone Round Wall Clock""",12,7,0,8,27
GBC DocuBind P400 Electric Binding System,11,0,8,8,27
GBC DocuBind P100 Manual Binding Machine,10,6,3,8,27
Xerox 226,9,21,15,8,53
Boston Heavy-Duty Trimline Electric Pencil Sharpeners,9,0,8,8,25
Wilson Jones Standard D-Ring Binders,8,5,5,8,26
Compact Automatic Electric Letter Opener,8,3,7,8,26
Zebra Zazzle Fluorescent Highlighters,8,0,4,8,20
"Acco Four Pocket Poly Ring Binder with Label Holder, Smoke, 1""",7,8,5,8,28
Newell 321,7,7,0,8,22
Surelock Post Binders,7,5,9,8,29
Sony 16GB Class 10 Micro SDHC R40 Memory Card,7,1,0,8,16
Hon Pagoda Stacking Chairs,6,8,0,8,22
Plantronics S12 Corded Telephone Headset System,6,3,6,8,23
Multicolor Computer Printout Paper,6,2,3,8,19
Xerox 1897,6,2,0,8,16
"Tenex File Box, Personal Filing Tote with Lid, Black",6,0,10,8,24
"3M Polarizing Task Lamp with Clamp Arm, Light Gray",6,0,2,8,16
Avery 501,5,9,0,8,22
Lumber Crayons,5,6,0,8,19
Xerox 211,5,6,0,8,19
Smead Alpha-Z Color-Coded Name Labels First Letter Starter Set,5,5,2,8,20
Avery 495,5,0,3,8,16
Personal Creations Ink Jet Cards and Labels,4,16,0,8,28
"Boston School Pro Electric Pencil Sharpener, 1670",4,11,9,8,32
Self-Adhesive Address Labels for Typewriters by Universal,4,4,7,8,23
Tennsco Regal Shelving Units,4,3,3,8,18
Sauder Cornerstone Collection Library,4,2,0,8,14
"Wirebound Message Books, Four 2 3/4 x 5 White Forms per Page",4,0,22,8,34
Logitech G105 Gaming Keyboard,4,0,2,8,14
Xerox 1966,4,0,2,8,14
Clarity 53712,4,0,2,8,14
Avery 476,3,15,11,8,37
Advantus Rolling Storage Box,3,8,8,8,27
"Fellowes Premier Superior Surge Suppressor, 10-Outlet, With Phone and Remote",3,8,2,8,21
Bevis Round Conference Table Top & Single Column Base,3,8,0,8,19
Newell 34,3,7,7,8,25
"Chromcraft Bull-Nose Wood Round Conference Table Top, Wood Base",3,7,0,8,18
SanDisk Ultra 64 GB MicroSDHC Class 10 Memory Card,3,6,8,8,25
APC 7 Outlet Network SurgeArrest Surge Protector,3,2,7,8,20
Crate-A-Files,3,2,5,8,18
"Howard Miller 14-1/2 Diameter Chrome Round Wall Clock""",3,0,18,8,29
"Wirebound Four 2-3/4 x 5 Forms per Page, 400 Sets per Book",3,0,11,8,22
Security-Tint Envelopes,2,9,4,8,23
"GBC Pre-Punched Binding Paper, Plastic, White, 8-1/2 x 11""""",2,4,17,8,31
Boston 1645 Deluxe Heavier-Duty Electric Pencil Sharpener,2,4,13,8,27
Fellowes Staxonsteel Drawer Files,2,4,12,8,26
"Multi-Use Personal File Cart and Caster Set, Three Stacking Bins",2,1,0,8,11
"Sauder Mission Library with Doors, Fruitwood Finish",2,0,0,8,10
Canon Imageclass D680 Copier / Fax,1,5,2,8,16
PowerGen Dual USB Car Charger,1,0,5,8,14
Xerox 1883,0,25,4,8,37
"Global Armless Task Chair, Royal Blue",0,15,5,8,28
Mitel MiVoice 5330e IP Phone,0,14,12,8,34
Avery Hi-Liter Smear-Safe Highlighters,0,11,5,8,24
Xerox 188,0,11,1,8,20
Home/Office Personal File Carts,0,9,13,8,30
Wilson Jones “Snap” Scratch Pad Binder Tool for Ring Binders,0,9,5,8,22
Xerox 1962,0,8,12,8,28
"Important Message Pads, 50 4-1/4 x 5-1/2 Forms per Pad",0,7,0,8,15
Panasonic KP-380BK Classic Electric Pencil Sharpener,0,6,8,8,22
Fellowes Command Center 5-outlet power strip,0,6,1,8,15
Plantronics Calisto P620-M USB Wireless Speakerphone System,0,5,1,8,14
"XtraLife ClearVue Slant-D Ring Binder, White, 3""",0,4,27,8,39
Jackery Bar Premium Fast-charging Portable Charger,0,4,6,8,18
"White Dual Perf Computer Printout Paper, 2700 Sheets, 1 Part, Heavyweight, 20 lbs., 14 7/8 x 11",0,3,13,8,24
Binder Posts,0,3,5,8,16
Dexim XPower Skin Super-Thin Power Case for iPhone 5 - Black,0,3,0,8,11
36X48 HARDFLOOR CHAIRMAT,0,2,11,8,21
Eldon Advantage Foldable Chair Mats for Low Pile Carpets,0,2,0,8,10
"Telephone Message Books with Fax/Mobile Section, 5 1/2 x 3 3/16""""",0,0,9,8,17
V7 USB Numeric Keypad,0,0,8,8,16
"Safco Value Mate Steel Bookcase, Baked Enamel Finish on Steel, Black",0,0,6,8,14
Sony Micro Vault Click 8 GB USB 2.0 Flash Drive,0,0,5,8,13
"Manila Recycled Extra-Heavyweight Clasp Envelopes, 6 x 9""""",0,0,5,8,13
Jabra SPEAK 410 Multidevice Speakerphone,0,0,5,8,13
Magnifier Swing Arm Lamp,0,0,4,8,12
14-7/8 x 11 Blue Bar Computer Printout Paper,0,0,2,8,10
Newell 339,0,0,2,8,10
"Quartet Alpha White Chalk, 12/Pack",0,0,0,8,8
Xerox 1980,0,0,0,8,8
Plastic Stacking Crates & Casters,0,0,0,8,8
Belkin 8 Outlet SurgeMaster II Gold Surge Protector with Phone Protection,0,0,0,8,8
"Global Adaptabilites Bookcase, Cherry/Storm Gray Finish",0,0,0,8,8
"Southworth 100% Résumé Paper, 24lb.",28,0,0,7,35
"Safco Chair Connectors, 6/Carton",19,0,0,7,26
Xerox 195,17,0,3,7,27
"Carina Mini System Audio Rack, Model AR050B",16,0,3,7,26
Avery 480,15,1,1,7,24
Belkin 8 Outlet Surge Protector,14,7,2,7,30
Xerox 1949,14,6,1,7,28
Newell 351,14,1,4,7,26
Hon Every-Day Series Multi-Task Chairs,13,13,10,7,43
Xerox 216,13,11,11,7,42
"Eldon Expressions Wood and Plastic Desk Accessories, Cherry Wood",13,3,0,7,23
"Master Caster Door Stop, Brown",12,5,14,7,38
GBC Instant Index System for Binding Systems,12,0,0,7,19
Xerox 1934,11,0,2,7,20
Lexmark MX611dhe Monochrome Laser Printer,11,0,0,7,18
Holmes Odor Grabber,10,10,3,7,30
Recycled Pressboard Report Cover with Reinforced Top Hinge,10,2,15,7,34
"Carina 42Hx23 3/4""W Media Storage Unit""",10,1,4,7,22
DIXON Oriole Pencils,10,0,2,7,19
"Hot File 7-Pocket, Floor Stand",9,15,18,7,49
"Master Caster Door Stop, Large Neon Orange",9,9,2,7,27
"Seth Thomas 16 Steel Case Clock""",9,3,0,7,19
Nontoxic Chalk,9,0,11,7,27
Kensington 7 Outlet MasterPiece Power Center,8,2,4,7,21
"Global Value Steno Chair, Gray",7,14,15,7,43
Tenex Chairmats For Use with Hard Floors,7,6,0,7,20
Xerox 1898,7,5,27,7,46
Tripp Lite TLP810NET Broadband Surge for Modem/Fax,7,5,3,7,22
Hoover Commercial Soft Guard Upright Vacuum And Disposable Filtration Bags,7,4,0,7,18
Xerox 213,7,2,2,7,18
Acrylic Self-Standing Desk Frames,6,17,7,7,37
"White Business Envelopes with Contemporary Seam, Recycled White Business Envelopes",6,15,6,7,34
"Acco PRESSTEX Data Binder with Storage Hooks, Dark Blue, 14 7/8 X 11""""",6,12,12,7,37
"Logitech B530 USB Headset - headset - Full size, Binaural",6,10,2,7,25
"BOSTON Ranger #55 Pencil Sharpener, Black",6,4,10,7,27
Office Star Flex Back Scooter Chair with Aluminum Finish Frame,6,0,7,7,20
GBC DocuBind 200 Manual Binding Machine,6,0,2,7,15
Wilson Jones Heavy-Duty Casebound Ring Binders with Metal Hinges,5,10,0,7,22
Nokia Lumia 521 (T-Mobile),5,5,3,7,20
Avery 506,5,5,0,7,17
First Data FD10 PIN Pad,5,4,8,7,24
Newell Chalk Holder,5,4,5,7,21
"Hon Practical Foundations 30 x 60 Training Table, Light Gray/Charcoal",5,3,7,7,22
Convenience Packs of Business Envelopes,5,3,3,7,18
Plantronics 81402,5,3,0,7,15
"Tennsco Lockers, Gray",5,2,8,7,22
"Sanford EarthWrite Recycled Pencils, Medium Soft, #2",5,0,2,7,14
American Pencil,4,5,5,7,21
GBC Linen Binding Covers,4,4,3,7,18
Luxo Economy Swing Arm Lamp,4,4,2,7,17
G.E. Longer-Life Indoor Recessed Floodlight Bulbs,4,3,2,7,16
OIC Bulk Pack Metal Binder Clips,3,7,13,7,30
Samsung HM1900 Bluetooth Headset,3,7,10,7,27
"Avery Trapezoid Extra Heavy Duty 4 Binders""",3,5,0,7,15
Belkin 8 Outlet SurgeMaster II Gold Surge Protector,3,5,0,7,15
"Square Ring Data Binders, Rigid 75 Pt. Covers, 11 x 14-7/8""""",3,4,8,7,22
"Acco Banker's Clasps, 5 3/4-Long""",3,4,1,7,15
Newell 345,3,3,13,7,26
Sterilite Show Offs Storage Containers,3,3,3,7,16
"Plantronics CS 50-USB - headset - Convertible, Monaural",3,3,0,7,13
Sony 32GB Class 10 Micro SDHC R40 Memory Card,3,2,0,7,12
Canon PC1080F Personal Copier,3,1,0,7,11
Hon 4700 Series Mobuis Mid-Back Task Chairs with Adjustable Arms,3,0,14,7,24
Safco Drafting Table,3,0,2,7,12
Epson TM-T88V Direct Thermal Printer - Monochrome - Desktop,3,0,0,7,10
Advantus Panel Wall Certificate Holder - 8.5x11,2,5,9,7,23
Angle-D Ring Binders,2,3,2,7,14
SAFCO Optional Arm Kit for Workspace Cribbage Stacking Chair,2,3,0,7,12
"Companion Letter/Legal File, Black",2,2,6,7,17
Memorex Micro Travel Drive 32 GB,2,1,2,7,12
"Howard Miller 13-1/2 Diameter Rosebrook Wall Clock""",2,0,8,7,17
"Stacking Tray, Side-Loading, Legal, Smoke",2,0,7,7,16
Presstex Flexible Ring Binders,1,5,17,7,30
Martin-Yale Premier Letter Opener,1,5,7,7,20
"Universal Recycled Hanging Pressboard Report Binders, Letter Size",1,2,10,7,20
Avery 49,1,0,16,7,24
"DXL Angle-View Binders with Locking Rings, Black",0,19,0,7,26
Kensington 4 Outlet MasterPiece Compact Power Control Center,0,18,11,7,36
Razer Kraken PRO Over Ear PC and Music Headset,0,17,6,7,30
Xerox 1977,0,11,2,7,20
"Iris 3-Drawer Stacking Bin, Black",0,9,0,7,16
Novimex High-Tech Fabric Mesh Task Chair,0,9,0,7,16
Xerox 222,0,8,7,7,22
Canon PC-428 Personal Copier,0,7,11,7,25
Xerox 1935,0,7,7,7,21
Gear Head AU3700S Headset,0,7,2,7,16
Hoover Shoulder Vac Commercial Portable Vacuum,0,6,3,7,16
HP Office Recycled Paper (20Lb. and 87 Bright),0,5,7,7,19
KeyTronic E03601U1 - Keyboard - Beige,0,5,6,7,18
Samsung Galaxy S4 Mini,0,5,3,7,15
O'Sullivan Manor Hill 2-Door Library in Brianna Oak,0,5,0,7,12
Heavy-Duty E-Z-D Binders,0,4,18,7,29
Xerox 201,0,4,8,7,19
Fiskars Softgrip Scissors,0,3,18,7,28
Barrel Sharpener,0,3,9,7,19
Xerox 22,0,3,3,7,13
"Master Caster Door Stop, Gray",0,3,0,7,10
"Elite 5 Scissors""",0,2,15,7,24
Wilson Jones International Size A4 Ring Binders,0,2,9,7,18
"Tyvek  Top-Opening Peel & Seel  Envelopes, Gray",0,2,8,7,17
Newell 307,0,2,3,7,12
Self-Adhesive Address Labels for Typewriters with Dispenser Box,0,2,0,7,9
"DAX Charcoal/Nickel-Tone Document Frame, 5 x 7",0,1,15,7,23
ClearOne Communications CHAT 70 OC Speaker Phone,0,1,4,7,12
"DAX Executive Solid Wood Document Frame, Desktop or Hang, Mahogany, 5 x 7",0,0,10,7,17
"Dixon Ticonderoga Erasable Colored Pencil Set, 12-Color",0,0,7,7,14
Samsung Galaxy Note 2,0,0,7,7,14
DAX Two-Tone Silver Metal Document Frame,0,0,6,7,13
Harmony HEPA Quiet Air Purifiers,0,0,5,7,12
Xerox 1975,0,0,5,7,12
Euro Pro Shark Stick Mini Vacuum,0,0,4,7,11
"TOPS Money Receipt Book, Consecutively Numbered in Red,",0,0,4,7,11
Newell 33,0,0,3,7,10
"Acco Recycled 2 Capacity Laser Printer Hanging Data Binders""",0,0,3,7,10
Letter Size File,0,0,3,7,10
Xerox 1938,0,0,0,7,7
Col-Erase Pencils with Erasers,0,0,0,7,7
Canon Image Class D660 Copier,0,0,0,7,7
Tennsco 6- and 18-Compartment Lockers,22,8,7,6,43
Avery 485,21,24,0,6,51
Global Deluxe High-Back Manager's Chair,21,4,4,6,35
Chromcraft Rectangular Conference Tables,18,2,4,6,30
Space Solutions HD Industrial Steel Shelving.,17,0,4,6,27
Mophie Juice Pack Helium for iPhone,15,0,3,6,24
O'Sullivan Living Dimensions 2-Shelf Bookcases,14,3,5,6,28
Macally Suction Cup Mount,13,0,7,6,26
Xerox 1933,13,0,5,6,24
Newell 320,12,5,0,6,23
Fellowes PB200 Plastic Comb Binding Machine,11,11,10,6,38
Xerox 217,11,0,8,6,25
C-Line Cubicle Keepers Polyproplyene Holder With Velcro Backings,10,7,8,6,31
GBC Wire Binding Combs,10,5,5,6,26
"#10 White Business Envelopes,4 1/8 x 9 1/2",10,1,15,6,32
Global Highback Leather Tilter in Burgundy,9,16,3,6,34
Avery Self-Adhesive Photo Pockets for Polaroid Photos,9,13,13,6,41
"DAX Value U-Channel Document Frames, Easel Back",9,6,15,6,36
Case Logic 2.4GHz Wireless Keyboard,9,4,8,6,27
Hypercom P1300 Pinpad,8,5,2,6,21
GE DSL Phone Line Filter,8,0,1,6,15
Poly Designer Cover & Back,7,8,14,6,35
Logitech G600 MMO Gaming Mouse,7,8,0,6,21
GBC Standard Therm-A-Bind Covers,7,5,16,6,34
"Dixon My First Ticonderoga Pencil, #2",7,3,3,6,19
"Avery Framed View Binder, EZD Ring (Locking), Navy, 1 1/2""",7,2,4,6,19
"Dixon Ticonderoga Core-Lock Colored Pencils, 48-Color Set",7,0,0,6,13
Harbour Creations Steel Folding Chair,6,16,6,6,34
Safco Contoured Stacking Chairs,5,16,0,6,27
"Bevis Round Bullnose 29 High Table Top""",5,12,1,6,24
Ibico Covers for Plastic or Wire Binding Elements,5,5,4,6,20
"Binney & Smith Crayola Metallic Colored Pencils, 8-Color Set",5,4,5,6,20
"DAX Copper Panel Document Frame, 5 x 7 Size",5,4,3,6,18
Global Comet Stacking Armless Chair,5,3,0,6,14
Acme Softgrip Scissors,5,0,12,6,23
Avery Legal 4-Ring Binder,5,0,5,6,16
Plantronics Savi W720 Multi-Device Wireless Headset System,4,11,3,6,24
"C-Line Peel & Stick Add-On Filing Pockets, 8-3/4 x 5-1/8, 10/Pack",4,6,5,6,21
Wilson SignalBoost 841262 DB PRO Amplifier Kit,4,5,2,6,17
Samsung Galaxy S4,4,1,2,6,13
Jabra Supreme Plus Driver Edition Headset,4,0,12,6,22
Xerox 1942,4,0,3,6,13
Eldon ProFile File 'N Store Portable File Tub Letter/Legal Size Black,3,26,0,6,35
Hon 2090 “Pillow Soft” Series Mid Back Swivel/Tilt Chairs,3,11,4,6,24
3-ring staple pack,3,10,7,6,26
"Eldon Spacemaker Box, Quick-Snap Lid, Clear",3,8,1,6,18
Global Deluxe Office Fabric Chairs,3,8,0,6,17
"Sauder Camden County Collection Libraries, Planked Cherry Finish",3,5,5,6,19
Imation Clip USB flash drive - 8 GB,3,4,12,6,25
Avery 483,3,3,7,6,19
Hon 4070 Series Pagoda Round Back Stacking Chairs,3,2,10,6,21
Newell 330,3,2,0,6,11
Xerox 1993,3,0,15,6,24
"Eldon Expressions Desk Accessory, Wood Photo Frame, Mahogany",3,0,11,6,20
Global Executive Mid-Back Manager's Chair,3,0,9,6,18
Newell 327,3,0,9,6,18
iOttie HLCRIO102 Car Mount,3,0,3,6,12
Panasonic KX TS3282B Corded phone,3,0,0,6,9
Avery Poly Binder Pockets,2,11,15,6,34
Fellowes High-Stak Drawer Files,2,11,7,6,26
Ideal Clamps,2,5,20,6,33
"Executive Impressions 14 Contract Wall Clock""",2,5,4,6,17
Logitech Trackman Marble Mouse,2,3,17,6,28
Maxell 4.7GB DVD+R 5/Pack,2,3,2,6,13
Safco Industrial Shelving,2,0,5,6,13
Telescoping Adjustable Floor Lamp,2,0,2,6,10
Tennsco Industrial Shelving,1,13,9,6,29
Belkin 7-Outlet SurgeMaster Home Series,1,0,3,6,10
Cush Cases Heavy Duty Rugged Cover Case for Samsung Galaxy S5 - Purple,0,11,0,6,17
Xerox 212,0,10,9,6,25
Xerox 1991,0,9,11,6,26
Hon Mobius Operator's Chair,0,7,10,6,23
Nu-Dell Oak Frame,0,7,3,6,16
Avery 486,0,6,12,6,24
Office Star - Contemporary Task Swivel Chair,0,6,8,6,20
"Wirebound Message Books, 5-1/2 x 4 Forms, 2 or 4 Forms per Page",0,6,0,6,12
Xerox 1953,0,6,0,6,12
GBC Therma-A-Bind 250T Electric Binding System,0,6,0,6,12
Durable Pressboard Binders,0,5,0,6,11
"Tenex Personal Self-Stacking Standard File Box, Black/Gray",0,4,5,6,15
Acme Elite Stainless Steel Scissors,0,4,2,6,12
Xerox 1937,0,4,2,6,12
Tensor Brushed Steel Torchiere Floor Lamp,0,4,0,6,10
3M Office Air Cleaner,0,4,0,6,10
Newell 326,0,3,14,6,23
Hon Comfortask Task/Swivel Chairs,0,3,9,6,18
Deluxe Rollaway Locking File with Drawer,0,3,5,6,14
Bady BDG101FRU Card Printer,0,3,5,6,14
Jensen SMPS-640 - speaker phone,0,3,3,6,12
Xerox 1936,0,3,0,6,9
#6 3/4 Gummed Flap White Envelopes,0,3,0,6,9
Ibico Recycled Linen-Style Covers,0,2,16,6,24
GBC VeloBinder Electric Binding Machine,0,2,7,6,15
Xerox 19,0,2,7,6,15
Tennsco 16-Compartment Lockers with Coat Rack,0,2,5,6,13
"Bush Andora Conference Table, Maple/Graphite Gray Finish",0,2,4,6,12
Avery 500,0,2,0,6,8
Ibico EB-19 Dual Function Manual Binding System,0,0,17,6,23
Southworth 25% Cotton Linen-Finish Paper & Envelopes,0,0,14,6,20
Belkin F9M820V08 8 Outlet Surge,0,0,9,6,15
Avery 496,0,0,8,6,14
Newell 328,0,0,7,6,13
"Global Task Chair, Black",0,0,6,6,12
Cyber Acoustics AC-202b Speech Recognition Stereo Headset,0,0,5,6,11
Array Memo Cubes,0,0,5,6,11
Xerox 1907,0,0,4,6,10
Okidata MB491 Multifunction Printer,0,0,3,6,9
Belkin iPhone and iPad Lightning Cable,0,0,1,6,7
Kingston Digital DataTraveler 64GB USB 2.0,0,0,0,6,6
Lexmark 20R1285 X6650 Wireless All-in-One Printer,0,0,0,6,6
Xerox 1951,16,7,2,5,30
Southworth 25% Cotton Premium Laser Paper and Envelopes,15,0,8,5,28
High-Back Leather Manager's Chair,14,13,10,5,42
"Adams While You Were Out"" Message Pads""",14,5,0,5,24
Acco Perma 3000 Stacking Storage Drawers,14,2,0,5,21
Acco 6 Outlet Guardian Premium Surge Suppressor,13,6,11,5,35
Round Specialty Laser Printer Labels,13,4,17,5,39
"Avery Triangle Shaped Sheet Lifters, Black, 2/Pack",12,2,6,5,25
Xerox 1913,12,0,0,5,17
Ibico Standard Transparent Covers,11,9,9,5,34
Logitech Gaming G510s - Keyboard,11,9,6,5,31
"Deflect-o EconoMat Studded, No Bevel Mat for Low Pile Carpeting",11,3,14,5,33
DAX Cubicle Frames - 8x10,11,0,10,5,26
Xerox 1956,11,0,0,5,16
Xerox 1971,10,10,3,5,28
Peel & Stick Add-On Corner Pockets,10,7,8,5,30
Eldon Mobile Mega Data Cart  Mega Stackable  Add-On Trays,10,7,8,5,30
"Verbatim 25 GB 6x Blu-ray Single Layer Recordable Disc, 3/Pack",10,5,10,5,30
Large Capacity Hanging Post Binders,10,2,5,5,22
Avery 514,10,2,0,5,17
Pressboard Data Binders by Wilson Jones,9,9,4,5,27
Model L Table or Wall-Mount Pencil Sharpener,9,7,3,5,24
Apple iPhone 5,9,0,10,5,24
Enermax Aurora Lite Keyboard,9,0,7,5,21
VTech DS6151,8,6,6,5,25
"Deflect-o SuperTray Unbreakable Stackable Tray, Letter, Black",8,5,0,5,18
Newell 343,8,0,11,5,24
"Seth Thomas 14 Putty-Colored Wall Clock""",8,0,0,5,13
"Atlantic Metals Mobile 4-Shelf Bookcases, Custom Colors",7,13,2,5,27
Peel & Seel Envelopes,7,6,0,5,18
AT&T 1080 Corded phone,7,6,0,5,18
Sony Micro Vault Click 16 GB USB 2.0 Flash Drive,7,5,12,5,29
Panasonic KX-TG9471B,7,5,10,5,27
GBC VeloBinder Strips,7,0,8,5,20
Adtran 1202752G1,7,0,6,5,18
Boston Home & Office Model 2000 Electric Pencil Sharpeners,7,0,1,5,13
Hoover Upright Vacuum With Dirt Cup,6,17,3,5,31
Xerox 1970,6,8,3,5,22
"Green Canvas Binder for 8-1/2 x 14"" Sheets""",6,5,3,5,19
Globe Weis Peel & Seel First Class Envelopes,6,4,15,5,30
DYMO CardScan Personal V9 Business Card Scanner,6,0,0,5,11
Newell 334,5,16,1,5,27
Tenex Antistatic Computer Chair Mats,5,15,0,5,25
Bush Advantage Collection Round Conference Table,5,9,0,5,19
"Computer Room Manger, 14""",5,7,5,5,22
Xerox 210,5,6,2,5,18
Advantus T-Pin Paper Clips,5,4,2,5,16
Acco Hot Clips Clips to Go,5,0,13,5,23
Ibico EPK-21 Electric Binding System,5,0,3,5,13
Xerox 1955,5,0,0,5,10
Xerox 1881,4,18,11,5,38
Logitech G602 Wireless Gaming Mouse,4,12,8,5,29
"TOPS Carbonless Receipt Book, Four 2-3/4 x 7-1/4 Money Receipts per Page",4,11,5,5,25
Wilson Jones Active Use Binders,4,6,6,5,21
Belkin F8E887 USB Wired Ergonomic Keyboard,4,5,7,5,21
Acme Titanium Bonded Scissors,4,4,0,5,13
Swingline SM12-08 MicroCut Jam Free Shredder,4,4,0,5,13
Avery Binding System Hidden Tab Executive Style Index Sets,4,3,14,5,26
Newell 348,4,3,12,5,24
"Memorex 25GB 6X Branded Blu-Ray Recordable Disc, 30/Pack",4,1,7,5,17
BPI Conference Tables,4,0,17,5,26
"Executive Impressions 12 Wall Clock""",4,0,5,5,14
"Avery Hi-Liter GlideStik Fluorescent Highlighter, Yellow Ink",4,0,0,5,9
Xerox 21,3,16,0,5,24
Xerox 1978,3,13,13,5,34
JBL Micro Wireless Portable Bluetooth Speaker,3,6,3,5,17
"Floodlight Indoor Halogen Bulbs, 1 Bulb per Pack, 60 Watts",3,5,11,5,24
GBC Poly Designer Binding Covers,3,4,6,5,18
Regeneration Desk Collection,3,3,10,5,21
Newell 331,3,3,6,5,17
"Tenex Carpeted, Granite-Look or Clear Contemporary Contour Shape Chair Mats",3,3,4,5,15
"DAX Cubicle Frames, 8-1/2 x 11",3,2,7,5,17
DAX Clear Channel Poster Frame,3,2,0,5,10
Hon Deluxe Fabric Upholstered Stacking Chairs,3,0,7,5,15
"1.7 Cubic Foot Compact Cube"" Office Refrigerators""",3,0,6,5,14
Insertable Tab Indexes For Data Binders,3,0,5,5,13
Cisco SPA112 2 Port Phone Adapter,3,0,3,5,11
Quality Park Security Envelopes,3,0,3,5,11
Sannysis Cute Owl Design Soft Skin Case Cover for Samsung Galaxy S4,3,0,0,5,8
"Howard Miller 13 Diameter Pewter Finish Round Wall Clock""",2,15,5,5,27
Xerox 1963,2,10,0,5,17
Office Star Flex Back Scooter Chair with White Frame,2,3,11,5,21
"Metal Folding Chairs, Beige, 4/Carton",2,2,14,5,23
"Ampad Evidence Wirebond Steno Books, 6 x 9""""",2,2,5,5,14
"SAFCO PlanMaster Heigh-Adjustable Drafting Table Base, 43w x 30d x 30-37h, Black",2,1,6,5,14
"Leather Task Chair, Black",2,0,12,5,19
Safco Steel Mobile File Cart,2,0,2,5,9
Acme Kleencut Forged Steel Scissors,2,0,0,5,7
Hammermill CopyPlus Copy Paper (20Lb. and 84 Bright),2,0,0,5,7
Logitech M510 Wireless Mouse,2,0,0,5,7
Safco Industrial Wire Shelving,1,7,3,5,16
Great White Multi-Use Recycled Paper (20Lb. and 84 Bright),1,6,20,5,32
Computer Printout Index Tabs,1,0,9,5,15
Luxo Professional Magnifying Clamp-On Fluorescent Lamps,1,0,7,5,13
Logitech K350 2.4Ghz Wireless Keyboard,0,20,0,5,25
GBC Ibimaster 500 Manual ProClick Binding System,0,17,26,5,48
"Sanyo Counter Height Refrigerator with Crisper, 3.6 Cubic Foot, Stainless Steel/Black",0,13,0,5,18
"Executive Impressions 14 Two-Color Numerals Wall Clock""",0,11,0,5,16
Bagged Rubber Bands,0,10,6,5,21
"Sanford Colorific Eraseable Coloring Pencils, 12 Count",0,10,0,5,15
XtraLife ClearVue Slant-D Ring Binders by Cardinal,0,9,8,5,22
"Black Avery Memo-Size 3-Ring Binder, 5 1/2 x 8 1/2""""",0,9,2,5,16
"Howard Miller 12 Round Wall Clock""",0,9,0,5,14
Avery 491,0,7,0,5,12
Coloredge Poster Frame,0,5,11,5,21
Xerox 1959,0,5,11,5,21
"Speediset Carbonless Redi-Letter 7 x 8 1/2""""",0,5,9,5,19
Xerox 1910,0,5,4,5,14
"Holmes Replacement Filter for HEPA Air Cleaner, Large Room",0,5,2,5,12
"Belkin 325VA UPS Surge Protector, 6'",0,4,4,5,13
O'Sullivan Plantations 2-Door Library in Landvery Oak,0,3,14,5,22
Xerox 1914,0,3,11,5,19
Logitech Z-906 Speaker sys - home theater - 5.1-CH,0,3,9,5,17
"Perixx PERIBOARD-512B, Ergonomic Split Keyboard",0,3,4,5,12
Colorific Watercolor Pencils,0,3,3,5,11
Alliance Rubber Bands,0,3,0,5,8
Hewlett Packard 310 Color Digital Copier,0,2,9,5,16
Xerox 228,0,2,8,5,15
Holmes HEPA Air Purifier,0,2,7,5,14
Nortel Meridian M5316 Digital phone,0,1,7,5,13
"Recycled Interoffice Envelopes with String and Button Closure, 10 x 13",0,1,6,5,12
"Electrix Architect's Clamp-On Swing Arm Lamp, Black",0,0,28,5,33
"GE General Purpose, Extra Long Life, Showcase & Floodlight Incandescent Bulbs",0,0,15,5,20
Translucent Push Pins by OIC,0,0,10,5,15
HP Office Paper (20Lb. and 87 Bright),0,0,9,5,14
Super Decoflex Portable Personal File,0,0,8,5,13
Avaya 5420 Digital phone,0,0,7,5,12
Bush Somerset Collection Bookcase,0,0,7,5,12
"Ultra Door Kickplate, 8H x 34""W""",0,0,5,5,10
Logitech Wireless Headset H600 Over-The-Head Design,0,0,5,5,10
Acco Perma 2700 Stacking Storage Drawers,0,0,3,5,8
Motorola Moto X,0,0,1,5,6
SAFCO Folding Chair Trolley,0,0,1,5,6
Acco Glide Clips,0,0,0,5,5
Cisco Desktop Collaboration Experience DX650 IP Video Phone,0,0,0,5,5
"Wirebound Message Forms, Four 2 3/4 x 5 Forms per Page, Pink Paper",0,0,0,5,5
Hewlett-Packard Desktjet 6988DT Refurbished Printer,0,0,0,5,5
Unpadded Memo Slips,0,0,0,5,5
"Iceberg Nesting Folding Chair, 19w x 6d x 43h",22,5,0,4,31
Avery 492,16,0,0,4,20
Recycled Steel Personal File for Standard File Folders,16,0,0,4,20
Polycom SoundPoint Pro SE-225 Corded phone,14,0,1,4,19
Office Star - Professional Matrix Back Chair with 2-to-1 Synchro Tilt and Mesh Fabric Seat,13,5,6,4,28
Bevis 44 x 96 Conference Tables,13,0,3,4,20
Westinghouse Clip-On Gooseneck Lamps,12,9,13,4,38
"SAFCO Commercial Wire Shelving, Black",11,8,12,4,35
Xerox 1941,11,4,0,4,19
"Tyvek  Top-Opening Peel & Seel Envelopes, Plain White",11,1,8,4,24
Fellowes Super Stor/Drawer Files,10,13,0,4,27
Economy Rollaway Files,10,6,0,4,20
Cisco 8x8 Inc. 6753i IP Business Phone System,10,3,9,4,26
Honeywell Quietcare HEPA Air Cleaner,10,0,9,4,23
Xerox 2000,10,0,0,4,14
Rogers Profile Extra Capacity Storage Tub,9,5,14,4,32
Panasonic Kx-TS550,9,1,9,4,23
Global Leather Executive Chair,9,0,8,4,21
Acme Office Executive Series Stainless Steel Trimmers,9,0,8,4,21
Office Star - Ergonomic Mid Back Chair with 2-Way Adjustable Arms,9,0,0,4,13
netTALK DUO VoIP Telephone Service,8,5,9,4,26
BlackBerry Q10,8,4,11,4,27
Airmail Envelopes,8,2,5,4,19
Fellowes Mighty 8 Compact Surge Protector,8,0,7,4,19
"Premium Writing Pencils, Soft, #2 by Central Association for the Blind",7,15,3,4,29
Recycled Eldon Regeneration Jumbo File,7,9,0,4,20
Innergie mMini Combo Duo USB Travel Charging Kit,7,8,0,4,19
"Lesro Round Back Collection Coffee Table, End Table",7,5,4,4,20
Deluxe Chalkboard Eraser Cleaner,7,4,2,4,17
GBC Standard Plastic Binding Systems Combs,7,0,2,4,13
Seidio BD2-HK3IPH5-BK DILEX Case and Holster Combo for Apple iPhone 5/5s - Black,7,0,0,4,11
Poly String Tie Envelopes,6,15,10,4,35
Belkin 6 Outlet Metallic Surge Strip,6,15,4,4,29
"Global Deluxe Stacking Chair, Gray",6,6,3,4,19
"Wirebound Message Books, Two 4 1/4 x 5"" Forms per Page""",6,4,1,4,15
Laser & Ink Jet Business Envelopes,6,3,7,4,20
Acco Smartsocket Color-Coded Six-Outlet AC Adapter Model Surge Protectors,6,1,3,4,14
Mitel 5320 IP Phone VoIP phone,6,0,4,4,14
KeyTronic 6101 Series - Keyboard - Black,6,0,0,4,10
Xerox 192,5,4,9,4,22
Safco Commercial Shelving,5,0,2,4,11
Xerox 205,4,16,0,4,24
"Personal Filing Tote with Lid, Black/Gray",4,11,12,4,31
NETGEAR N750 Dual Band Wi-Fi Gigabit Router,4,8,6,4,22
Office Star - Ergonomically Designed Knee Chair,4,7,4,4,19
Xerox 1948,4,7,0,4,15
"Hoover Replacement Belts For Soft Guard & Commercial Ltweight Upright Vacs, 2/Pk",4,5,5,4,18
ClearOne CHATAttach 160 - speaker phone,4,3,2,4,13
Newell 332,4,0,16,4,24
Advantus Panel Wall Acrylic Frame,4,0,12,4,20
Xerox 1882,4,0,4,4,12
Xerox 1972,4,0,2,4,10
"BOSTON Model 1800 Electric Pencil Sharpeners, Putty/Woodgrain",3,23,0,4,30
"Message Book, Phone, Wirebound Standard Line Memo, 2 3/4 X 5""""",3,12,0,4,19
Square Credit Card Reader,3,8,7,4,22
UniKeep View Case Binders,3,6,0,4,13
Cisco SPA508G,3,4,4,4,15
"GBC Clear Cover, 8-1/2 x 11, unpunched, 25 covers per pack",3,4,4,4,15
ARKON Windshield Dashboard Air Vent Car Mount Holder,3,4,3,4,14
"DAX Metal Frame, Desktop, Stepped-Edge",3,4,0,4,11
"Rogers Jumbo File, Granite",3,3,14,4,24
Eldon Image Series Black Desk Accessories,3,2,3,4,12
"Conquest 14 Commercial Heavy-Duty Upright Vacuum, Collection System, Accessory Kit",3,2,3,4,12
Acco Expandable Hanging Binders,3,2,2,4,11
Plastic Binding Combs,3,0,16,4,23
Imation USB 2.0 Swivel Flash Drive USB flash drive - 4 GB - Pink,3,0,7,4,14
Economy #2 Pencils,3,0,6,4,13
"Bevis Traditional Conference Table Top, Plinth Base",3,0,2,4,9
Newell 333,2,18,9,4,33
Assorted Color Push Pins,2,13,2,4,21
Bevis Rectangular Conference Tables,2,5,2,4,13
Xerox 1899,2,4,4,4,14
"Acco Clips to Go Binder Clips, 24 Clips in Two Sizes",2,3,10,4,19
Maxell CD-R Discs,2,3,0,4,9
Flexible Leather- Look Classic Collection Ring Binder,1,5,3,4,13
"Global Leather & Oak Executive Chair, Burgundy",1,3,5,4,13
"Westinghouse Floor Lamp with Metal Mesh Shade, Black",1,2,0,4,7
Kingston Digital DataTraveler 8GB USB 2.0,1,0,4,4,9
Cisco SPA301,0,19,7,4,30
Jet-Pak Recycled Peel 'N' Seal Padded Mailers,0,14,1,4,19
"iKross Bluetooth Portable Keyboard + Cell Phone Stand Holder + Brush for Apple iPhone 5S 5C 5, 4S 4",0,12,8,4,24
Plantronics MX500i Earset,0,11,0,4,15
"Eldon Stackable Tray, Side-Load, Legal, Smoke",0,10,3,4,17
"#10-4 1/8 x 9 1/2"" Premium Diagonal Seam Envelopes""",0,9,0,4,13
Magna Visual Magnetic Picture Hangers,0,7,8,4,19
Contemporary Wood/Metal Frame,0,6,8,4,18
Sauder Barrister Bookcases,0,6,6,4,16
Avery 503,0,6,5,4,15
LG G3,0,6,0,4,10
Cisco SPA 502G IP Phone,0,5,12,4,21
"Eureka The Boss Plus 12-Amp Hard Box Upright Vacuum, Red",0,5,11,4,20
Anker 24W Portable Micro USB Car Charger,0,4,0,4,8
Hand-Finished Solid Wood Document Frame,0,4,0,4,8
Jabra BIZ 2300 Duo QD Duo Corded Headset,0,3,10,4,17
"Verbatim 25 GB 6x Blu-ray Single Layer Recordable Disc, 25/Pack",0,3,5,4,12
Artistic Insta-Plaque,0,3,3,4,10
"Tenex Contemporary Contur Chairmats for Low and Medium Pile Carpet, Computer, 39 x 49""""",0,3,3,4,10
Kensington 7 Outlet MasterPiece Power Center with Fax/Phone Line Protection,0,3,1,4,8
"Office Star - Contemporary Task Swivel chair with 2-way adjustable arms, Plum",0,3,0,4,7
Xerox 207,0,3,0,4,7
Xerox 196,0,2,12,4,18
Bush Mission Pointe Library,0,2,0,4,6
"Binney & Smith Crayola Metallic Crayons, 16-Color Pack",0,1,0,4,5
Sony Micro Vault Click 4 GB USB 2.0 Flash Drive,0,0,14,4,18
Eldon 500 Class Desk Accessories,0,0,13,4,17
Bretford “Just In Time” Height-Adjustable Multi-Task Work Tables,0,0,13,4,17
DAX Solid Wood Frames,0,0,9,4,13
"TOPS Voice Message Log Book, Flash Format",0,0,8,4,12
"3D Systems Cube Printer, 2nd Generation, Magenta",0,0,7,4,11
Standard Line “While You Were Out” Hardbound Telephone Message Book,0,0,7,4,11
Clearsounds A400,0,0,7,4,11
Global Deluxe High-Back Office Chair in Storm,0,0,6,4,10
Storex Flexible Poly Binders with Double Pockets,0,0,5,4,9
Nortel Business Series Terminal T7208 Digital phone,0,0,5,4,9
Eldon Executive Woodline II Cherry Finish Desk Accessories,0,0,2,4,6
Hoover Commercial Lightweight Upright Vacuum with E-Z Empty Dirt Cup,0,0,2,4,6
"Westinghouse Mesh Shade Clip-On Gooseneck Lamp, Black",0,0,2,4,6
Belkin 8-Outlet Premiere SurgeMaster II Surge Protectors,0,0,0,4,4
Cubify CubeX 3D Printer Triple Head Print,0,0,0,4,4
Xerox 1901,0,0,0,4,4
Computer Printout Paper with Letter-Trim Fine Perforations,0,0,0,4,4
"HP Officejet Pro 8600 e-All-In-One Printer, Copier, Scanner, Fax",0,0,0,4,4
Razer Kraken 7.1 Surround Sound Over Ear USB Gaming Headset,17,9,0,3,29
Acme Box Cutter Scissors,17,5,6,3,31
Xerox 1995,16,2,1,3,22
Avery 513,16,2,1,3,22
DAX Black Cherry Wood-Tone Poster Frame,15,6,0,3,24
Belkin F9H710-06 7 Outlet SurgeMaster Surge Protector,14,3,9,3,29
RCA Visys Integrated PBX 8-Line Router,14,2,0,3,19
"BIC Brite Liner Grip Highlighters, Assorted, 5/Pack",14,0,12,3,29
Jabra SPEAK 410,13,10,11,3,37
Newell 322,13,0,2,3,18
Novimex Swivel Fabric Task Chair,11,4,7,3,25
Fellowes 8 Outlet Superior Workstation Surge Protector,11,4,2,3,20
Maxell 4.7GB DVD-R 5/Pack,10,8,0,3,21
Avery Hidden Tab Dividers for Binding Systems,9,4,8,3,24
Newell 3-Hole Punched Plastic Slotted Magazine Holders for Binders,9,4,4,3,20
White Computer Printout Paper by Universal,9,3,22,3,37
DIXON Ticonderoga Erasable Checking Pencils,9,2,6,3,20
AT&T CL82213,8,6,0,3,17
Staple magnet,8,5,17,3,33
Avery 494,8,5,7,3,23
Xerox 1967,8,4,0,3,15
Acme Stainless Steel Office Snips,8,0,2,3,13
Apple iPhone 5S,8,0,0,3,11
24-Hour Round Wall Clock,7,10,7,3,27
Revere Boxed Rubber Bands by Revere,7,7,12,3,29
Avery 489,7,6,0,3,16
Sabrent 4-Port USB 2.0 Hub,7,4,1,3,15
Xerox 1923,7,3,3,3,16
Xerox 1960,6,17,6,3,32
GBC Personal VeloBind Strips,6,6,12,3,27
"Commercial WindTunnel Clean Air Upright Vacuum, Replacement Belts, Filtration Bags",6,2,6,3,17
Avery 509,6,1,3,3,13
Bevis Steel Folding Chairs,6,0,15,3,24
Aluminum Document Frame,6,0,13,3,22
Xerox 1987,6,0,7,3,16
Fellowes Desktop Hanging File Manager,5,5,2,3,15
Hewlett Packard 610 Color Digital Copier / Printer,5,4,9,3,21
Wi-Ex zBoost YX540 Cellular Phone Signal Booster,5,4,7,3,19
Fellowes Advanced Computer Series Surge Protectors,5,4,3,3,15
Avery 490,5,4,1,3,13
Balt Split Level Computer Training Table,5,4,0,3,12
Xerox 1925,5,0,10,3,18
WD My Passport Ultra 1TB Portable External Hard Drive,5,0,9,3,17
"Master Giant Foot Doorstop, Safety Yellow",5,0,4,3,12
GE 30522EE2,5,0,2,3,10
"Binney & Smith inkTank Erasable Desk Highlighter, Chisel Tip, Yellow, 12/Box",5,0,0,3,8
"Atlantic Metals Mobile 3-Shelf Bookcases, Custom Colors",4,18,10,3,35
"Hon Metal Bookcases, Black",4,18,5,3,30
Xerox 1903,4,17,0,3,24
"Holmes Replacement Filter for HEPA Air Cleaner, Very Large Room, HEPA Filter",4,12,7,3,26
Newell 319,4,10,11,3,28
"Acco PRESSTEX Data Binder with Storage Hooks, Dark Blue, 9 1/2 X 11""""",4,8,8,3,23
Xerox 1900,4,7,12,3,26
"Wilson Jones Hanging View Binder, White, 1""",4,7,9,3,23
HTC One,4,7,0,3,14
Xerox 1981,4,7,0,3,14
"Verbatim 25 GB 6x Blu-ray Single Layer Recordable Disc, 1/Pack",4,0,7,3,14
Tenex Chairmats For Use With Carpeted Floors,4,0,4,3,11
Mediabridge Sport Armband iPhone 5s,3,10,14,3,30
Sharp AL-1530CS Digital Copier,3,7,4,3,17
"Avery Durable Plastic 1 Binders""",3,5,23,3,34
"Deflect-o DuraMat Lighweight, Studded, Beveled Mat for Low Pile Carpeting",3,5,6,3,17
Bevis Boat-Shaped Conference Table,3,3,6,3,15
Fellowes Neat Ideas Storage Cubes,3,2,8,3,16
Panasonic KP-4ABK Battery-Operated Pencil Sharpener,3,0,10,3,16
File Shuttle I and Handi-File,3,0,7,3,13
VariCap6 Expandable Binder,3,0,4,3,10
Hoover WindTunnel Plus Canister Vacuum,3,0,3,3,9
12 Colored Short Pencils,3,0,2,3,8
Contemporary Borderless Frame,3,0,0,3,6
Document Clip Frames,3,0,0,3,6
Boston KS Multi-Size Manual Pencil Sharpener,2,9,11,3,25
Bose SoundLink Bluetooth Speaker,2,7,6,3,18
Memorex Micro Travel Drive 4 GB,2,6,0,3,11
HP Standard 104 key PS/2 Keyboard,2,5,10,3,20
Xerox 200,2,5,5,3,15
Panasonic KX T7736-B Digital phone,2,5,0,3,10
Electrix Halogen Magnifier Lamp,2,4,8,3,17
"Howard Miller 11-1/2 Diameter Grantwood Wall Clock""",2,3,6,3,14
Akro-Mils 12-Gallon Tote,2,3,5,3,13
"Sauder Facets Collection Library, Sky Alder Finish",2,3,2,3,10
Eldon Cleatmat Chair Mats for Medium Pile Carpets,2,3,0,3,8
Trimflex Flexible Post Binders,2,0,16,3,21
Blackstonian Pencils,2,0,14,3,19
Premier Automatic Letter Opener,2,0,9,3,14
Global Enterprise Series Seating High-Back Swivel/Tilt Chairs,2,0,5,3,10
Samsung Rugby III,1,17,3,3,24
Eldon Advantage Chair Mats for Low to Medium Pile Carpets,1,3,6,3,13
Faber Castell Col-Erase Pencils,1,3,1,3,8
Tops Green Bar Computer Printout Paper,1,0,3,3,7
Wirebound Voice Message Log Book,1,0,0,3,4
Avery 482,1,0,0,3,4
Anker Ultra-Slim Mini Bluetooth 3.0 Wireless Keyboard,0,21,2,3,26
"Eldon Imàge Series Desk Accessories, Clear",0,14,0,3,17
"Deflect-o EconoMat Nonstudded, No Bevel Mat",0,9,2,3,14
Fellowes Recycled Storage Drawers,0,9,0,3,12
Logitech G35 7.1-Channel Surround Sound Headset,0,8,6,3,17
"Sauder Forest Hills Library, Woodland Oak Finish",0,8,4,3,15
AmazonBasics 3-Button USB Wired Mouse,0,8,3,3,14
Dixon Ticonderoga Pencils,0,8,2,3,13
Global Comet Stacking Arm Chair,0,7,7,3,17
Rubber Band Ball,0,7,6,3,16
"Iceberg OfficeWorks 42 Round Tables""",0,6,21,3,30
Xerox 208,0,6,0,3,9
Wausau Papers Astrobrights Colored Envelopes,0,6,0,3,9
Xerox 1886,0,5,6,3,14
Boston 1730 StandUp Electric Pencil Sharpener,0,5,0,3,8
"Sanford Prismacolor Professional Thick Lead Art Pencils, 36-Color Set",0,4,0,3,7
Avery 510,0,4,0,3,7
KLD Oscar II Style Snap-on Ultra Thin Side Flip Synthetic Leather Cover Case for HTC One HTC M7,0,3,7,3,13
Disposable Triple-Filter Dust Bags,0,3,4,3,10
"Verbatim Slim CD and DVD Storage Cases, 50/Pack",0,3,2,3,8
"Sanford Colorific Colored Pencils, 12/Box",0,2,21,3,26
Avery 50,0,2,15,3,20
JM Magazine Binder,0,2,13,3,18
Xerox 206,0,2,6,3,11
"#10 Gummed Flap White Envelopes, 100/Box",0,2,6,3,11
i.Sound Portable Power - 8000 mAh,0,2,4,3,9
"Brites Rubber Bands, 1 1/2 oz. Box",0,2,2,3,7
Xerox 1890,0,2,0,3,5
Newell 346,0,1,7,3,11
KeyTronic KT800P2 - Keyboard - Black,0,1,2,3,6
Rush Hierlooms Collection Rich Wood Bookcases,0,1,0,3,4
"Bush Cubix Collection Bookcases, Fully Assembled",0,1,0,3,4
Anker Astro 15000mAh USB Portable Charger,0,0,10,3,13
Avaya 5410 Digital phone,0,0,10,3,13
Xerox 1911,0,0,10,3,13
GBC ProClick Spines for 32-Hole Punch,0,0,9,3,12
Electrix Fluorescent Magnifier Lamps & Weighted Base,0,0,8,3,11
AT&T CL83451 4-Handset Telephone,0,0,7,3,10
Hon Every-Day Chair Series Swivel Task Chairs,0,0,7,3,10
Newell 338,0,0,5,3,8
"Dixon Ticonderoga Maple Cedar Pencil, #2",0,0,5,3,8
Xerox 215,0,0,4,3,7
Hewlett-Packard Deskjet 5550 Printer,0,0,0,3,3
Sony 8GB Class 10 Micro SDHC R40 Memory Card,0,0,0,3,3
Panasonic Business Telephones KX-T7736,0,0,0,3,3
"Fellowes Smart Surge Ten-Outlet Protector, Platinum",0,0,0,3,3
I.R.I.S IRISCard Anywhere 5 Card Scanner,0,0,0,3,3
Color-Coded Legal Exhibit Labels,0,0,0,3,3
Socket Bluetooth Cordless Hand Scanner (CHS),0,0,0,3,3
"Stride Job 150 Highlighters, Chisel Tip, Assorted Colors",0,0,0,3,3
Decoflex Hanging Personal Folder File,0,0,0,3,3
Wasp CCD Handheld Bar Code Reader,0,0,0,3,3
Advantus Rolling Drawer Organizers,20,3,6,2,31
Hon Olson Stacker Stools,19,10,13,2,44
"Bush Heritage Pine Collection 5-Shelf Bookcase, Albany Pine Finish, *Special Order",16,9,7,2,34
Xerox 1952,13,3,2,2,20
Acco Side-Punched Conventional Columnar Pads,13,0,0,2,15
Belkin F9G930V10-GRY 9 Outlet Surge,12,2,0,2,16
"Global Leather Highback Executive Chair with Pneumatic Height Adjustment, Black",11,12,14,2,39
Ultra Door Push Plate,11,7,14,2,34
Stacking Trays by OIC,11,0,6,2,19
Ooma Telo VoIP Home Phone System,11,0,5,2,18
OIC Thumb-Tacks,11,0,0,2,13
Acco 6 Outlet Guardian Standard Surge Suppressor,10,3,0,2,15
Riverleaf Stik-Withit Designer Note Cubes,10,0,3,2,15
Newell 317,9,18,3,2,32
"Eldon Regeneration Recycled Desk Accessories, Smoke",9,6,4,2,21
StarTech.com 10/100 VDSL2 Ethernet Extender Kit,9,2,0,2,13
Ames Color-File Green Diamond Border X-ray Mailers,9,0,7,2,18
Acme Value Line Scissors,8,4,8,2,22
"Contico 72H Heavy-Duty Storage System""",8,2,4,2,16
Acme Kleen Earth Office Shears,8,0,2,2,12
Newell 341,7,4,10,2,23
Logitech Wireless Anywhere Mouse MX for PC and Mac,7,2,0,2,11
Self-Adhesive Ring Binder Labels,7,2,0,2,11
Newell 324,6,12,3,2,23
Avery Durable Slant Ring Binders With Label Holder,6,5,23,2,36
Dana Swing-Arm Lamps,6,5,2,2,15
Acco Perma 4000 Stacking Storage Drawers,6,4,19,2,31
Eureka Sanitaire  Commercial Upright,6,0,4,2,12
AT&T CL2909,6,0,0,2,8
Hoover Commercial Lightweight Upright Vacuum,6,0,0,2,8
Office Star - Task Chair with Contemporary Loop Arms,6,0,0,2,8
AT&T 17929 Lendline Telephone,5,13,15,2,35
Brother DCP1000 Digital 3 in 1 Multifunction Machine,5,10,2,2,19
2300 Heavy-Duty Transfer File Systems by Perma,5,9,0,2,16
Logitech Mobile Speakerphone P710e - speaker phone,5,6,4,2,17
"Eldon Expressions Punched Metal & Wood Desk Accessories, Pewter & Cherry",5,6,0,2,13
Xerox 1912,5,2,2,2,11
Konftel 250 Conference phone - Charcoal black,5,2,0,2,9
OtterBox Commuter Series Case - Samsung Galaxy S4,4,12,0,2,18
Bionaire 99.97% HEPA Air Cleaner,4,7,3,2,16
"Sauder Camden County Barrister Bookcase, Planked Cherry Finish",4,4,0,2,10
Deflect-o DuraMat Antistatic Studded Beveled Mat for Medium Pile Carpeting,4,2,10,2,18
Shocksock Galaxy S4 Armband,4,1,0,2,7
Akro Stacking Bins,4,0,7,2,13
Deflect-o Glass Clear Studded Chair Mats,3,18,3,2,26
Computer Printout Paper with Letter-Trim Perforations,3,12,7,2,24
"Boston Electric Pencil Sharpener, Model 1818, Charcoal Black",3,10,5,2,20
GBC Plastic Binding Combs,3,8,17,2,30
"TOPS 4 x 6 Fluorescent Color Memo Sheets, 500 Sheets per Pack",3,8,0,2,13
Advantus Map Pennant Flags and Round Head Tacks,3,6,14,2,25
50 Colored Long Pencils,3,6,3,2,14
"C-Line Cubicle Keepers Polyproplyene Holder w/Velcro Back, 8-1/2x11, 25/Bx",3,6,2,2,13
Advantus Push Pins,3,5,17,2,27
Woodgrain Magazine Files by Perma,3,5,14,2,24
Avery 508,3,5,9,2,19
Sharp 1540cs Digital Laser Copier,3,5,0,2,10
Newell 335,3,4,3,2,12
Wilson Jones data.warehouse D-Ring Binders with DublLock,3,3,4,2,12
Balt Solid Wood Rectangular Table,3,3,3,2,11
"Acco Smartsocket Table Surge Protector, 6 Color-Coded Adapter Outlets",3,3,0,2,8
Xerox 1921,3,0,2,2,7
Acco Economy Flexible Poly Round Ring Binder,3,0,1,2,6
Riverside Furniture Stanwyck Manor Table Series,3,0,0,2,5
Xerox 1999,2,11,2,2,17
Smead Alpha-Z Color-Coded Second Alphabetical Labels and Starter Set,2,10,2,2,16
AT&T SB67148 SynJ,2,0,4,2,8
"Logitech Wireless Boombox Speaker - portable - wireless, wired",2,0,0,2,4
"Adams Telephone Message Books, 5 1/4” x 11”",1,10,2,2,15
Hon Rectangular Conference Tables,1,7,10,2,20
"Barricks 18 x 48"" Non-Folding Utility Table with Bottom Storage Shelf""",1,7,6,2,16
SANFORD Liquid Accent Tank-Style Highlighters,1,2,0,2,5
Avery 487,1,0,22,2,25
"Eldon Image Series Desk Accessories, Ebony",1,0,15,2,18
"Riverside Palais Royal Lawyers Bookcase, Royale Cherry Finish",0,18,4,2,24
Hon Olson Stacker Chairs,0,16,4,2,22
Xerox 1928,0,15,9,2,26
Boston 19500 Mighty Mite Electric Pencil Sharpener,0,15,0,2,17
"Seth Thomas 13 1/2 Wall Clock""",0,14,4,2,20
Xerox 219,0,13,0,2,15
Cisco IP Phone 7961G-GE VoIP phone,0,11,2,2,15
"Blue String-Tie & Button Interoffice Envelopes, 10 x 13",0,10,10,2,22
Tyvek Side-Opening Peel & Seel Expanding Envelopes,0,8,4,2,14
Lenovo 17-Key USB Numeric Keypad,0,8,3,2,13
Xerox 1880,0,6,10,2,18
"Sauder Forest Hills Library with Doors, Woodland Oak Finish",0,6,2,2,10
GBC Binding covers,0,5,4,2,11
Xerox 1950,0,5,2,2,9
Xerox 202,0,4,22,2,28
Xerox 1946,0,4,7,2,13
"Mini 13-1/2 Capacity Data Binder Rack, Pearl",0,4,6,2,12
Lexmark MarkNet N8150 Wireless Print Server,0,4,0,2,6
Hoover Replacement Belt for Commercial Guardsman Heavy-Duty Upright Vacuum,0,4,0,2,6
LG Electronics Tone+ HBS-730 Bluetooth Headset,0,3,13,2,18
Xerox 1943,0,3,11,2,16
Apple EarPods with Remote and Mic,0,3,5,2,10
Anker Astro Mini 3000mAh Ultra-Compact Portable Charger,0,3,4,2,9
OtterBox Defender Series Case - iPhone 5c,0,3,0,2,5
"Avery 05222 Permanent Self-Adhesive File Folder Labels for Typewriters, on Rolls, White, 250/Roll",0,3,0,2,5
Anderson Hickey Conga Table Tops & Accessories,0,3,0,2,5
"Tenex Personal Filing Tote With Secure Closure Lid, Black/Frost",0,2,18,2,22
Micro Innovations USB RF Wireless Keyboard with Mouse,0,2,14,2,18
Cubify CubeX 3D Printer Double Head Print,0,2,5,2,9
Xerox 218,0,2,4,2,8
Fiskars Spring-Action Scissors,0,2,2,2,6
"Tenex Traditional Chairmats for Hard Floors, Average Lip, 36 x 48""""",0,2,0,2,4
Micro Innovations Wireless Classic Keyboard with Mouse,0,2,0,2,4
Sanford Pocket Accent Highlighters,0,0,12,2,14
Avery 493,0,0,11,2,13
Ampad #10 Peel & Seel Holiday Envelopes,0,0,10,2,12
Boston 16765 Mini Stand Up Battery Pencil Sharpener,0,0,8,2,10
#10 Self-Seal White Envelopes,0,0,8,2,10
Avery 502,0,0,5,2,7
"Ink Jet Note and Greeting Cards, 8-1/2 x 5-1/2"" Card Size""",0,0,4,2,6
Okidata C610n Printer,0,0,3,2,5
Kleencut Forged Office Shears by Acme United Corporation,0,0,3,2,5
Xerox 1958,0,0,3,2,5
Avery 515,0,0,3,2,5
Cisco CP-7937G Unified IP Conference Station Phone,0,0,2,2,4
Newell 337,0,0,2,2,4
"Atlantic Metals Mobile 2-Shelf Bookcases, Custom Colors",0,0,1,2,3
Xerox 1984,0,0,0,2,2
Eureka Disposable Bags for Sanitaire Vibra Groomer I Upright Vac,0,0,0,2,2
Multimedia Mailers,0,0,0,2,2
Avery 5,0,0,0,2,2
Xerox 1989,0,0,0,2,2
Xerox 1969,0,0,0,2,2
Microsoft Natural Keyboard Elite,19,9,0,1,29
DMI Eclipse Executive Suite Bookcases,12,6,8,1,27
NETGEAR AC1750 Dual Band Gigabit Smart WiFi Router,11,0,6,1,18
ClearSounds CSC500 Amplified Spirit Phone Corded phone,10,5,3,1,19
Colored Push Pins,10,0,4,1,15
Dana Halogen Swing-Arm Architect Lamp,8,16,3,1,28
Pastel Pink Envelopes,8,0,0,1,9
Panasonic KX TS3282W Corded phone,7,9,8,1,25
"Wirebound Service Call Books, 5 1/2 x 4""""",7,3,2,1,13
Wilson Jones Suede Grain Vinyl Binders,7,0,0,1,8
Avery Premier Heavy-Duty Binder with Round Locking Rings,6,13,1,1,21
Hon Racetrack Conference Tables,6,8,7,1,22
Project Tote Personal File,6,7,1,1,15
G.E. Halogen Desk Lamp Bulbs,6,2,2,1,11
Rosewill 107 Normal Keys USB Wired Standard Keyboard,6,0,2,1,9
"Personal Folder Holder, Ebony",5,3,5,1,14
"Executive Impressions 14""",5,0,11,1,17
Xerox 194,5,0,3,1,9
Tuff Stuff Recycled Round Ring Binders,4,11,7,1,23
Desktop 3-Pocket Hot File,4,0,0,1,5
Imation Swivel Flash Drive USB flash drive - 8 GB,4,0,0,1,5
Brown Kraft Recycled Envelopes,3,8,3,1,15
"Dixon Prang Watercolor Pencils, 10-Color Set with Brush",3,5,18,1,27
Xerox 199,3,3,9,1,16
Harmony Air Purifier,2,5,5,1,13
Kensington SlimBlade Notebook Wireless Mouse with Nano Receiver ,2,3,7,1,13
"3D Systems Cube Printer, 2nd Generation, White",2,0,0,1,3
"Executive Impressions 13-1/2 Indoor/Outdoor Wall Clock""",2,0,0,1,3
Cardinal Poly Pocket Divider Pockets for Ring Binders,1,13,0,1,15
Sanford 52201 APSCO Electric Pencil Sharpener,1,12,0,1,14
Avery 520,1,4,9,1,15
Avery Binder Labels,1,0,6,1,8
"White Envelopes, White Envelopes with Clear Poly Window",0,18,3,1,22
Southworth 25% Cotton Antique Laid Paper & Envelopes,0,13,12,1,26
"Black Print Carbonless Snap-Off Rapid Letter, 8 1/2 x 7""""",0,11,7,1,19
LG Exalt,0,8,3,1,12
"Tensor Hersey Kiss"" Styled Floor Lamp""",0,7,0,1,8
Speck Products Candyshell Flip Case,0,7,0,1,8
Avery 497,0,7,0,1,8
"Holmes Visible Mist Ultrasonic Humidifier with 2.3-Gallon Output per Day, Replacement Filter",0,4,0,1,5
Avery Personal Creations Heavyweight Cards,0,3,7,1,11
Cisco Small Business SPA 502G VoIP phone,0,3,7,1,11
Ibico Recycled Grain-Textured Covers,0,2,5,1,8
Panasonic KP-350BK Electric Pencil Sharpener with Auto Stop,0,2,1,1,4
"Boston 1827 Commercial Additional Cutter, Drive Gear & Gear Rack for 1606",0,2,0,1,3
Belkin OmniView SE Rackmount Kit,0,0,6,1,7
O'Sullivan Cherrywood Estates Traditional Bookcase,0,0,5,1,6
"Eldon 300 Class Desk Accessories, Black",0,0,5,1,6
"Executive Impressions 16-1/2 Circular Wall Clock""",0,0,3,1,4
First Data TMFD35 PIN Pad,0,0,3,1,4
Okidata B400 Printer,0,0,2,1,3
"Bush Saratoga Collection 5-Shelf Bookcase, Hanover Cherry, *Special Order",0,0,0,1,1
Global Enterprise Series Seating Low-Back Swivel/Tilt Chairs,0,0,0,1,1
"Maxell 74 Minute CD-R Spindle, 50/Pack",24,0,0,0,24
Motorola Droid Maxx,21,0,0,0,21
Plantronics HL10 Handset Lifter,20,4,0,0,24
Staple-on labels,18,0,3,0,21
Wilson Jones 14 Line Acrylic Coated Pressboard Data Binders,17,6,0,0,23
Avery Heavy-Duty EZD View Binder with Locking Rings,16,20,5,0,41
Imation 30456 USB Flash Drive 8GB,16,0,7,0,23
Xerox 1954,16,0,2,0,18
"Global Push Button Manager's Chair, Indigo",15,22,7,0,44
Fellowes Bankers Box Recycled Super Stor/Drawer,15,0,9,0,24
"SAFCO Commercial Wire Shelving, 72h",15,0,9,0,24
EcoTones Memo Sheets,15,0,0,0,15
Belkin Standard 104 key USB Keyboard,14,7,0,0,21
Fellowes Super Stor/Drawer,14,4,0,0,18
"Fellowes Personal Hanging Folder Files, Navy",14,0,10,0,24
White GlueTop Scratch Pads,14,0,0,0,14
"Global Stack Chair with Arms, Black",13,5,13,0,31
Xerox 232,13,0,6,0,19
"Array Parchment Paper, Assorted Colors",13,0,2,0,15
Xerox 198,12,4,0,0,16
"Alliance Super-Size Bands, Assorted Sizes",12,0,15,0,27
KeyTronic KT400U2 - Keyboard - Black,12,0,3,0,15
AT&T TR1909W,12,0,3,0,15
Avery 516,12,0,3,0,15
"Hon Metal Bookcases, Gray",12,0,0,0,12
Avery Non-Stick Heavy Duty View Round Locking Ring Binders,12,0,0,0,12
Wilson Jones Custom Binder Spines & Labels,11,8,3,0,22
Newell 32,11,5,1,0,17
"Rush Hierlooms Collection 1 Thick Stackable Bookcases""",11,4,0,0,15
"Eldon Expressions Desk Accessory, Wood Pencil Holder, Oak",11,4,0,0,15
"Permanent Self-Adhesive File Folder Labels for Typewriters, 1 1/8 x 3 1/2, White",11,3,15,0,29
Wireless Extenders zBoost YX545 SOHO Signal Booster,11,3,10,0,24
Belkin F5C206VTEL 6 Outlet Surge,11,3,8,0,22
"Eldon Base for stackable storage shelf, platinum",11,2,12,0,25
Acme Design Stainless Steel Bent Scissors,11,0,2,0,13
Cisco IP Phone 7961G VoIP phone - Dark gray,11,0,1,0,12
"Sanford Colorific Scented Colored Pencils, 12/Pack",11,0,0,0,11
Ibico Laser Imprintable Binding System Covers,10,13,11,0,34
Cameo Buff Policy Envelopes,10,13,5,0,28
"Tennsco Snap-Together Open Shelving Units, Starter Sets and Add-On Units",10,7,8,0,25
"Seth Thomas 14 Day/Date Wall Clock""",10,4,3,0,17
Xerox 1929,10,3,3,0,16
Sauder Inglewood Library Bookcases,10,3,1,0,14
Memorex Mini Travel Drive 64 GB USB 2.0 Flash Drive,10,1,4,0,15
Xerox 224,10,0,7,0,17
"Memo Book, 100 Message Capacity, 5 3/8” x 11”",10,0,2,0,12
O'Sullivan Living Dimensions 5-Shelf Bookcases,9,9,3,0,21
Maxell DVD-RAM Discs,9,9,0,0,18
Avery 477,9,6,5,0,20
Hon 2111 Invitation Series Corner Table,9,6,3,0,18
Nu-Dell Float Frame 11 x 14 1/2,9,2,11,0,22
Imation 32GB Pocket Pro USB 3.0 Flash Drive - 32 GB - Black - 1 P ...,9,2,7,0,18
Xerox 229,9,0,6,0,15
"Eldon 200 Class Desk Accessories, Black",9,0,3,0,12
"Binney & Smith inkTank Erasable Pocket Highlighter, Chisel Tip, Yellow",9,0,3,0,12
Smead Adjustable Mobile File Trolley with Lockable Top,9,0,3,0,12
"Black Print Carbonless 8 1/2 x 8 1/4"" Rapid Memo Book""",9,0,2,0,11
"Dana Fluorescent Magnifying Lamp, White, 36""",8,6,0,0,14
"Gould Plastics 9-Pocket Panel Bin, 18-3/8w x 5-1/4d x 20-1/2h, Black",8,4,8,0,20
"Snap-A-Way Black Print Carbonless Ruled Speed Letter, Triplicate",8,3,17,0,28
Polycom CX300 Desktop Phone USB VoIP phone,8,2,5,0,15
Eldon Cleatmat Plus Chair Mats for High Pile Carpets,8,0,12,0,20
Avery White Multi-Purpose Labels,8,0,12,0,20
Global Italian Leather Office Chair,8,0,0,0,8
"Geographics Note Cards, Blank, White, 8 1/2 x 11""""",8,0,0,0,8
"Hunt BOSTON Model 1606 High-Volume Electric Pencil Sharpener, Beige",8,0,0,0,8
Portable Personal File Box,7,9,3,0,19
Samsung Galaxy Note 3,7,6,0,0,13
Cisco Unified IP Phone 7945G VoIP phone,7,5,14,0,26
Apple iPhone 5C,7,5,3,0,15
Southworth Parchment Paper & Envelopes,7,4,4,0,15
Avery 51,7,3,6,0,16
SanDisk Cruzer 16 GB USB Flash Drive,7,3,0,0,10
Samsung Galaxy S4 Active,7,1,0,0,8
Micropad Numeric Keypads,7,0,8,0,15
"HP Designjet T520 Inkjet Large Format Printer - 24 Color""",7,0,5,0,12
AT&T 1070 Corded Phone,7,0,5,0,12
"Hon Deluxe Fabric Upholstered Stacking Chairs, Squared Back",7,0,0,0,7
Acco 6 Outlet Guardian Basic Surge Suppressor,7,0,0,0,7
Xerox 1926,7,0,0,0,7
Xerox WorkCentre 6505DN Laser Multifunction Printer,7,0,0,0,7
"Stur-D-Stor Shelving, Vertical 5-Shelf: 72H x 36""W x 18 1/2""D""",6,14,3,0,23
Eldon ClusterMat Chair Mat with Cordless Antistatic Protection,6,9,3,0,18
"GE General Use Halogen Bulbs, 100 Watts, 1 Bulb per Pack",6,9,0,0,15
Fellowes Presentation Covers for Comb Binding Machines,6,8,0,0,14
Hon Non-Folding Utility Tables,6,4,19,0,29
Jawbone JAMBOX Wireless Bluetooth Speaker,6,4,4,0,14
Maxell 4.7GB DVD-RW 3/Pack,6,4,0,0,10
"Executive Impressions 10 Spectator Wall Clock""",6,3,13,0,22
Euro-Pro Shark Turbo Vacuum,6,2,16,0,24
Hon 4060 Series Tables,6,0,7,0,13
"Holmes Cool Mist Humidifier for the Whole House with 8-Gallon Output per Day, Extended Life Filter",6,0,3,0,9
"GE 4 Foot Flourescent Tube, 40 Watt",6,0,1,0,7
"Hon 30 x 60"" Table with Locking Drawer""",6,0,0,0,6
Hewlett-Packard Deskjet 6540 Color Inkjet Printer,6,0,0,0,6
Cisco TelePresence System EX90 Videoconferencing Unit,6,0,0,0,6
Enermax Acrylux Wireless Keyboard,5,24,0,0,29
Stanley Contemporary Battery Pencil Sharpeners,5,19,0,0,24
Xerox 1944,5,5,6,0,16
"Master Caster Door Stop, Large Brown",5,5,0,0,10
"Fellowes Strictly Business Drawer File, Letter/Legal Size",5,4,24,0,33
Luxo Adjustable Task Clamp Lamp,5,4,9,0,18
WD My Passport Ultra 500GB Portable External Hard Drive,5,4,3,0,12
Belkin QODE FastFit Bluetooth Keyboard,5,4,0,0,9
Panasonic KX T7731-B Digital phone,5,2,1,0,8
Xerox 190,5,1,0,0,6
High Speed Automatic Electric Letter Opener,5,0,6,0,11
"Chromcraft Bull-Nose Wood 48 x 96"" Rectangular Conference Tables""",5,0,6,0,11
Newell 329,5,0,3,0,8
"Hunt BOSTON Vista Battery-Operated Pencil Sharpener, Black",5,0,3,0,8
Xerox 1985,5,0,0,0,5
"Sanitaire Vibra Groomer IR Commercial Upright Vacuum, Replacement Belts",5,0,0,0,5
Eldon File Chest Portable File,5,0,0,0,5
Sterling Rubber Bands by Alliance,5,0,0,0,5
Plantronics Single Ear Headset,5,0,0,0,5
Avaya IP Phone 1140E VoIP phone,5,0,0,0,5
"Electrix Incandescent Magnifying Lamp, Black",5,0,0,0,5
"Perma STOR-ALL Hanging File Box, 13 1/8W x 12 1/4""D x 10 1/2""H""",4,18,11,0,33
Canon PC940 Copier,4,11,0,0,15
Xerox 1957,4,8,5,0,17
Ativa MDM8000 8-Sheet Micro-Cut Shredder,4,7,0,0,11
Xerox 1974,4,6,0,0,10
Eldon Pizzaz Desk Accessories,4,4,11,0,19
Acco Hanging Data Binders,4,4,9,0,17
Xerox 1994,4,3,6,0,13
Memorex Froggy Flash Drive 4 GB,4,2,8,0,14
Xerox 1979,4,2,5,0,11
"Pressboard Data Binder, Crimson, 12 X 8 1/2""""",4,2,3,0,9
Space Solutions Industrial Galvanized Steel Shelving.,4,1,2,0,7
Avery Heavy-Duty EZD  Binder With Locking Rings,4,0,24,0,28
Panasonic KP-150 Electric Pencil Sharpener,4,0,12,0,16
"BlueLounge Milo Smartphone Stand, White/Metallic",4,0,8,0,12
Ativa V4110MDD Micro-Cut Shredder,4,0,7,0,11
Southworth 25% Cotton Granite Paper & Envelopes,4,0,3,0,7
Xerox 1983,4,0,1,0,5
Boston 16750 Black Compact Battery Pencil Sharpener,4,0,1,0,5
Park Ridge Embossed Executive Business Envelopes,4,0,0,0,4
"Epson WorkForce WF-2530 All-in-One Printer, Copier Scanner",4,0,0,0,4
Xerox 1918,4,0,0,0,4
Hewlett-Packard Deskjet D4360 Printer,4,0,0,0,4
Bevis Round Conference Room Tables and Bases,4,0,0,0,4
Eldon 100 Class Desk Accessories,3,12,3,0,18
"Eldon L"" Workstation Diamond Chairmat""",3,11,5,0,19
Howard Miller 12-3/4 Diameter Accuwave DS  Wall Clock,3,11,0,0,14
Avery Hanging File Binders,3,9,14,0,26
"While You Were Out Pads, 50 per Pad, 4 x 5 1/4, Green Cycle",3,9,1,0,13
Polycom SoundStation2 EX Conference phone,3,9,0,0,12
Newell 315,3,6,16,0,25
Bretford CR8500 Series Meeting Room Furniture,3,6,12,0,21
Avery 488,3,6,8,0,17
"GBC Laser Imprintable Binding System Covers, Desert Sand",3,6,8,0,17
"Strathmore #10 Envelopes, Ultimate White",3,6,3,0,12
Kensington 6 Outlet MasterPiece HOMEOFFICE Power Control Center,3,6,0,0,9
Acme Rosewood Handle Letter Opener,3,5,4,0,12
Xerox 1889,3,5,2,0,10
Eldon Econocleat Chair Mats for Low Pile Carpets,3,5,0,0,8
Xerox 1990,3,5,0,0,8
GE 2-Jack Phone Line Splitter,3,4,4,0,11
Ultra Door Pull Handle,3,3,21,0,27
Southworth 100% Cotton The Best Paper,3,3,9,0,15
Texas Instruments TI-34 Scientific Calculator,3,3,6,0,12
Plantronics Voyager Pro Legend,3,3,2,0,8
Avery 479,3,3,1,0,7
Boston 16701 Slimline Battery Pencil Sharpener,3,3,0,0,6
Kensington 6 Outlet SmartSocket Surge Protector,3,3,0,0,6
"Alliance Big Bands Rubber Bands, 12/Pack",3,2,10,0,15
"Adams Phone Message Book, Professional, 400 Message Capacity, 5 3/6” x 11”",3,2,9,0,14
Acme Serrated Blade Letter Opener,3,2,0,0,5
Classic Ivory Antique Telephone ZL1810,3,1,0,0,4
Southworth Structures Collection,3,0,7,0,10
Newell 340,3,0,6,0,9
Xerox 1976,3,0,4,0,7
Cisco SPA 501G IP Phone,3,0,0,0,3
RCA ViSYS 25425RE1 Corded phone,3,0,0,0,3
Logitech Illuminated Ultrathin Keyboard with Backlighting,3,0,0,0,3
AT&T EL51110 DECT,3,0,0,0,3
Epson Perfection V600 Photo Scanner,3,0,0,0,3
Holmes Harmony HEPA Air Purifier for 17 x 20 Room,3,0,0,0,3
Stiletto Hand Letter Openers,2,12,3,0,17
HTC One Mini,2,10,7,0,19
"Seth Thomas 8 1/2 Cubicle Clock""",2,9,0,0,11
Xerox 204,2,8,7,0,17
"DAX Contemporary Wood Frame with Silver Metal Mat, Desktop, 11 x 14 Size",2,8,5,0,15
Newell 313,2,8,0,0,10
Fellowes Advanced 8 Outlet Surge Suppressor with Phone/Fax Protection,2,8,0,0,10
Xerox 1964,2,7,24,0,33
Tops Wirebound Message Log Books,2,5,18,0,25
"Safco Value Mate Series Steel Bookcases, Baked Enamel Finish on Steel, Gray",2,5,10,0,17
Newell 308,2,3,0,0,5
Okidata C331dn Printer,2,2,8,0,12
Xerox 1902,2,2,0,0,4
Star Micronics TSP800 TSP847IIU Receipt Printer,2,2,0,0,4
"Avery Hi-Liter Comfort Grip Fluorescent Highlighter, Yellow Ink",2,2,0,0,4
Advantus Motivational Note Cards,2,1,17,0,20
Xerox 1986,2,1,10,0,13
Turquoise Lead Holder with Pocket Clip,2,1,3,0,6
Holmes 99% HEPA Air Purifier,2,0,15,0,17
Strathmore Photo Frame Cards,2,0,14,0,16
Xerox 1965,2,0,8,0,10
Serrated Blade or Curved Handle Hand Letter Openers,2,0,7,0,9
Xerox 1892,2,0,3,0,5
Wilson Jones Hanging Recycled Pressboard Data Binders,2,0,2,0,4
Letter Slitter,2,0,2,0,4
Jiffy Padded Mailers with Self-Seal Closure,2,0,0,0,2
Canon imageCLASS MF7460 Monochrome Digital Laser Multifunction Copier,2,0,0,0,2
Hewlett-Packard Deskjet F4180 All-in-One Color Ink-jet - Printer / copier / scanner,2,0,0,0,2
PNY Rapid USB Car Charger - Black,2,0,0,0,2
Pizazz Global Quick File,1,13,10,0,24
Avery Round Ring Poly Binders,1,11,5,0,17
"Howard Miller 11-1/2 Diameter Ridgewood Wall Clock""",1,10,13,0,24
Griffin GC36547 PowerJolt SE Lightning Charger,1,7,2,0,10
Newell 31,1,6,17,0,24
Avery Hi-Liter Fluorescent Desk Style Markers,1,5,0,0,6
Xblue XB-1670-86 X16 Small Office Telephone - Titanium,1,4,0,0,5
Xerox 223,1,3,5,0,9
Lunatik TT5L-002 Taktik Strike Impact Protection System for iPhone 5,1,2,3,0,6
Belkin 7 Outlet SurgeMaster II,1,0,15,0,16
ShoreTel ShorePhone IP 230 VoIP phone,0,21,0,0,21
Cisco 9971 IP Video Phone Charcoal,0,16,0,0,16
Logitech VX Revolution Cordless Laser Mouse for Notebooks (Black),0,14,8,0,22
O'Sullivan Living Dimensions 3-Shelf Bookcases,0,14,3,0,17
Maxell 4.7GB DVD+RW 3/Pack,0,13,4,0,17
Zebra GX420t Direct Thermal/Thermal Transfer Printer,0,13,1,0,14
Logitech Keyboard K120,0,12,0,0,12
Xerox 1920,0,11,4,0,15
3M Replacement Filter for Office Air Cleaner for 20' x 33' Room,0,11,3,0,14
"Global Manager's Adjustable Task Chair, Storm",0,10,13,0,23
Avery 507,0,10,0,0,10
Universal Premium White Copier/Laser Paper (20Lb. and 87 Bright),0,9,15,0,24
Canon PC1060 Personal Laser Copier,0,9,10,0,19
O'Sullivan Cherrywood Estates Traditional Barrister Bookcase,0,9,0,0,9
Honeywell Enviracaire Portable HEPA Air Cleaner for up to 10 x 16 Room,0,8,4,0,12
Cardinal Hold-It CD Pocket,0,8,4,0,12
Nu-Dell EZ-Mount Plastic Wall Frames,0,8,0,0,8
Cisco SPA525G2 5-Line IP Phone,0,8,0,0,8
Xerox 1973,0,8,0,0,8
Petty Cash Envelope,0,7,3,0,10
Samsung Convoy 3,0,7,2,0,9
Microsoft Arc Touch Mouse,0,7,0,0,7
RCA ViSYS 25825 Wireless digital phone,0,7,0,0,7
Cardinal Holdit Data Disk Pockets,0,6,10,0,16
Sauder Camden County Collection Library,0,6,10,0,16
AT&T 1080 Phone,0,6,7,0,13
Rediform Voice Mail Log Books,0,6,5,0,11
"Eldon Regeneration Recycled Desk Accessories, Black",0,6,3,0,9
Portfile Personal File Boxes,0,6,1,0,7
Zebra ZM400 Thermal Label Printer,0,6,0,0,6
Round Ring Binders,0,5,23,0,28
"Boston Model 1800 Electric Pencil Sharpener, Gray",0,5,10,0,15
Grandstream GXP2100 Mainstream Business Phone,0,5,5,0,10
Lexmark S315 Color Inkjet Printer,0,5,0,0,5
Loose Memo Sheets,0,5,0,0,5
Dell Slim USB Multimedia Keyboard,0,5,0,0,5
Deflect-O Glasstique Clear Desk Accessories,0,4,13,0,17
"Bush Westfield Collection Bookcases, Dark Cherry Finish",0,4,10,0,14
Xerox 193,0,4,9,0,13
Newell 316,0,4,7,0,11
Recycled Premium Regency Composition Covers,0,4,5,0,9
Star Micronics TSP100 TSP143LAN Receipt Printer,0,4,0,0,4
Pyle PRT45 Retro Home Telephone,0,4,0,0,4
Rediform S.O.S. Phone Message Books,0,4,0,0,4
"Eureka Hand Vacuum, Bagless",0,4,0,0,4
SanDisk Cruzer 8 GB USB Flash Drive,0,4,0,0,4
Laminate Occasional Tables,0,3,15,0,18
Honeywell Enviracaire Portable HEPA Air Cleaner for 16' x 20' Room,0,3,11,0,14
3M Polarizing Light Filter Sleeves,0,3,11,0,14
"SmartStand Mobile Device Holder, Assorted Colors",0,3,10,0,13
"Howard Miller 16 Diameter Gallery Wall Clock""",0,3,9,0,12
Avaya 4621SW VoIP phone,0,3,9,0,12
"Executive Impressions 14 Contract Wall Clock with Quartz Movement""",0,3,5,0,8
Canon PC170 Desktop Personal Copier,0,3,3,0,6
Xerox 1896,0,3,2,0,5
"Vtech AT&T CL2940 Corded Speakerphone, Black",0,3,0,0,3
Xerox 1922,0,3,0,0,3
RCA H5401RE1 DECT 6.0 4-Line Cordless Handset With Caller ID/Call Waiting,0,3,0,0,3
Xerox 1932,0,3,0,0,3
Electrix 20W Halogen Replacement Bulb for Zoom-In Desk Lamp,0,2,11,0,13
O'Sullivan 5-Shelf Heavy-Duty Bookcases,0,2,7,0,9
"Recycled Interoffice Envelopes with Re-Use-A-Seal Closure, 10 x 13",0,2,3,0,5
SanDisk Cruzer 4 GB USB Flash Drive,0,2,3,0,5
NeatDesk Desktop Scanner & Digital Filing System,0,2,0,0,2
Ultra Commercial Grade Dual Valve Door Closer,0,2,0,0,2
GBC Wire Binding Strips,0,1,13,0,14
Wilson Jones DublLock D-Ring Binders,0,1,5,0,6
Boston 1900 Electric Pencil Sharpener,0,1,0,0,1
Xerox 20,0,1,0,0,1
Logitech G500s Laser Gaming Mouse with Adjustable Weight Tuning,0,0,21,0,21
"Tenex Chairmat w/ Average Lip, 45 x 53""""",0,0,19,0,19
Eldon Expressions Mahogany Wood Desk Collection,0,0,15,0,15
Advantus SlideClip Paper Clips,0,0,15,0,15
Embossed Ink Jet Note Cards,0,0,15,0,15
"Eldon Expressions Wood and Plastic Desk Accessories, Oak",0,0,15,0,15
Memorex Mini Travel Drive 32 GB USB 2.0 Flash Drive,0,0,14,0,14
Global Adaptabilities Conference Tables,0,0,14,0,14
Fiskars Home & Office Scissors,0,0,11,0,11
Panasonic KX MB2061 Multifunction Printer,0,0,10,0,10
Honeywell Enviracaire Portable Air Cleaner for up to 8 x 10 Room,0,0,9,0,9
Belkin Grip Candy Sheer Case / Cover for iPhone 5 and 5S,0,0,8,0,8
Texas Instrument TI-15 Fraction Calculator,0,0,8,0,8
Konica Minolta magicolor 1690MF Multifunction Printer,0,0,8,0,8
Hewlett-Packard Deskjet 3050a All-in-One Color Inkjet Printer,0,0,8,0,8
Okidata MB760 Printer,0,0,7,0,7
Fellowes Econo/Stor Drawers,0,0,7,0,7
4009 Highlighters,0,0,6,0,6
Zebra GK420t Direct Thermal/Thermal Transfer Printer,0,0,6,0,6
Xerox Blank Computer Paper,0,0,5,0,5
Belkin 7 Outlet SurgeMaster Surge Protector with Phone Protection,0,0,5,0,5
Stockwell Gold Paper Clips,0,0,5,0,5
LG G2,0,0,5,0,5
"Sauder Facets Collection Locker/File Cabinet, Sky Alder Finish",0,0,5,0,5
Panasonic KX MC6040 Color Laser Multifunction Printer,0,0,5,0,5
Xiaomi Mi3,0,0,4,0,4
Cherry 142-key Programmable Keyboard,0,0,4,0,4
Lexmark X 9575 Professional All-in-One Color Printer,0,0,4,0,4
Avery 484,0,0,4,0,4
"Snap-A-Way Black Print Carbonless Speed Message, No Reply Area, Duplicate",0,0,4,0,4
Nokia Lumia 1020,0,0,4,0,4
Okidata B401 Printer,0,0,3,0,3
"Canon Color ImageCLASS MF8580Cdw Wireless Laser All-In-One Printer, Copier, Scanner",0,0,3,0,3
"Brother MFC-9340CDW LED All-In-One Printer, Copier Scanner",0,0,3,0,3
"Linden 12 Wall Clock With Oak Frame""",0,0,3,0,3
Cisco 8961 IP Phone Charcoal,0,0,3,0,3
NETGEAR RangeMax WNR1000 Wireless Router,0,0,3,0,3
Hammermill Color Copier Paper (28Lb. and 96 Bright),0,0,3,0,3
Eldon Jumbo ProFile Portable File Boxes Graphite/Black,0,0,3,0,3
"Bush Westfield Collection Bookcases, Dark Cherry Finish, Fully Assembled",0,0,3,0,3
Newell 342,0,0,3,0,3
Memorex Mini Travel Drive 4 GB USB 2.0 Flash Drive,0,0,2,0,2
RCA ViSYS 25423RE1 Corded phone,0,0,2,0,2
Avery Hi-Liter Pen Style Six-Color Fluorescent Set,0,0,2,0,2
Grip Seal Envelopes,0,0,2,0,2
"Barricks Non-Folding Utility Table with Steel Legs, Laminate Tops",0,0,2,0,2
Penpower WorldCard Pro Card Scanner,0,0,1,0,1
"Pressboard Covers with Storage Hooks, 9 1/2 x 11""",,,,,
"Adams Telephone Message Book W/Dividers/Space For Phone Numbers, 5 1/4X8 1/2""",,,,,
"Acco Pressboard Covers with Storage Hooks, 14 7/8 x 11""",,,,,
"Wilson Jones Ledger-Size, Piano-Hinge Binder, 2",,,,,
"Tenex 46 x 60"" Computer Anti-Static Chairmat",,,,,
"Square Credit Card Reader, 4 1/2 x 4 1/2"" x 1""",,,,,
Linden 10 Round Wall Clock,,,,,
"Acco Pressboard Covers with Storage Hooks, 14 7/8 x 11""",,,,,
"Acco Pressboard Covers with Storage Hooks, 14 7/8 x 11""",,,,,
"GBC Twin Loop Wire Binding Elements, 9/16 Spine",,,,,
"REDIFORM Incoming/Outgoing Call Register, 11 X 8 1/2""",,,,,
Wilson Jones Elliptical Ring 3 1/2 Capacity Binders,,,,,
"Acme Hot Forged Carbon Steel Scissors with Nickel-Plated Handles, 3 7/8 Cut",,,,,
"Avery Trapezoid Ring Binder, 3 Capacity",,,,,
"Career Cubicle Clock, 8 1/4",,,,,
Belkin 19 Vented Equipment Shelf,,,,,
"Ampad Gold Fibre Wirebound Steno Books, 6 x 9""",,,,,
"TOPS Important Message"" Pads",,,,,
GE 48 Fluorescent Tube,,,,,
"Wirebound Message Books, 2 7/8 x 5""",,,,,
"Contract Clock, 14",,,,,
"Acco Pressboard Covers with Storage Hooks, 9 1/2 x 11""",,,,,
"Adams Telephone Message Book W/Dividers/Space For Phone Numbers, 5 1/4X8 1/2""",,,,,
"Tennsco Stur-D-Stor Boltless Shelving, 5 Shelves, 24 Deep",,,,,
Mead 1st Gear 2 Zipper Binder,,,,,
Avery 3 1/2 Diskette Storage Pages,,,,,
"While you Were Out"" Message Book",,,,,
"Safco Wire Cube Shelving System, For Use as 4 or 5 14 Cubes",,,,,
6 Cubicle Wall Clock,,,,,
"Rediform Wirebound Phone Memo"" Message Book",,,,,
"Wirebound Message Books, Four 2 3/4 x 5"" Forms per Page",,,,,
"Rubbermaid ClusterMat Chairmats, Mat Size- 66 x 60""",,,,,
"Recycled Desk Saver Line While You Were Out"" Book",,,,,
"IBM Multi-Purpose Copy Paper, 8 1/2 x 11",,,,,
Belkin 19 Center-Weighted Shelf,,,,,
"Xerox Color Copier Paper, 11 x 17""",,,,,
"Message Book, Wirebound, Four 5 1/2 X 4"" Forms/Pg.",,,,,
"Adams Write n' Stick Phone Message Book, 11 X 5 1/4""",,,,,
"OIC Binder Clips, Mini, 1/4 Capacity",,,,,
"RSVP Cards & Envelopes, Blank White, 8-1/2 X 11""",,,,,
"Eldon Delta Triangular Chair Mat, 52 x 58""",,,,,
"Universal Ultra Bright White Copier/Laser Paper, 8 1/2 x 11""",,,,,
"Tyvek Interoffice Envelopes, 9 1/2 x 12 1/2""",,,,,
"Eureka Recycled Copy Paper 8 1/2 x 11""",,,,,
"Tenex V2T-RE Standard Weight Series Chair Mat, 45 x 53""",,,,,
Fiskars 8 Scissors,,,,,
"Ampad Poly Cover Wirebound Steno Book, 6 x 9"" Assorted Colors",,,,,
Acme Design Line 8 Stainless Steel Bent Scissors w/Champagne Handles,,,,,
"Message Book, Standard Line While You Were Out""",,,,,
"Inter-Office Recycled Envelopes, Brown Kraft, Button-String,10 x 13"" ",,,,,
"SKILCRAFT Telephone Shoulder Rest, 2 x 6.5"" x 2.5""",,,,,
"1/4 Fold Party Design Invitations & White Envelopes, 24 8-1/2 X 11"" Cards",,,,,
